ID,Mission_Total,Weather_Total,Human_Factors_Total,Overall_Total,Callsign,TO_Time,TO_Date
16,0,5,2,7,CRAZE76,945,11/2/21
17,1,5,2,8,SCARE76,803,11/2/21
18,2,4,1,7,EVIL01,800,11/2/21
19,2,8,1,11,STAB11,1012,11/2/21
20,1,5,5,11,SCARE75,809,11/2/21
21,1,4,3,8,CRAZE16,815,11/2/21
22,1,4,6,11,CRAZE54,818,11/2/21
23,0,3,2,5,BADGR05,824,11/2/21
24,2,8,5,15,STAB11,833,11/2/21
25,0,4,3,7,PHNTM42,821,11/2/21
26,2,4,5,11,DRAGN,830,11/2/21
27,2,4,2,8,SMALL73,845,11/2/21
28,0,4,2,6,BADGR02,827,11/2/21
29,2,8,5,15,ETCH41,839,11/2/21
30,3,4,1,8,SMALL66,812,11/2/21
31,1,4,3,8,RECON02,906,11/2/21
32,2,4,0,6,BALL89,903,11/2/21
33,4,1,0,5,BALL58,900,11/2/21
34,2,5,1,8,RECON08,909,11/2/21
35,0,2,1,3,DRAGN59,848,11/2/21
36,2,4,1,7,BALL26,857,11/2/21
37,3,1,0,4,SMALL31,1003,11/2/21
38,4,10,6,20,TAUNT21,924,11/2/21
39,2,10,5,17,GOLEM31/32,918,11/2/21
40,2,8,4,14,TORA21/22,912,11/2/21
41,2,10,16,28,LOOKER1,951,11/2/21
42,0,4,4,8,CRAZE22,957,11/2/21
43,3,8,4,15,GIZMO21/22,930,11/2/21
44,1,5,2,8,DRAGN77,948,11/2/21
45,2,8,3,13,SHINR81/82,942,11/2/21
46,4,4,3,11,DRAGN42,954,11/2/21
47,0,4,5,9,DRAGN02,1009,11/2/21
48,0,4,1,5,DRAGN51,1006,11/2/21
49,0,4,1,5,DRAGN51,1006,11/2/21
50,2,8,4,14,LOADED1,936,11/2/21
51,2,3,0,5,DRAGN41,954,11/2/21
52,2,8,2,12,AXLE11,1018,11/2/21
53,0,5,3,8,BALL04,1033,11/2/21
54,3,10,2,15,WIRE31,1024,11/2/21
55,0,2,1,3,DAWG05,1100,11/2/21
56,0,6,2,8,FURY01,1030,11/2/21
58,2,5,3,10,Cobra 06,1112,11/2/21
59,3,5,5,13,Ghost,1103,11/2/21
60,2,6,2,10,PHNTM 50,1106,11/2/21
61,2,4,1,7,Cobra 01,1121,11/2/21
62,2,6,4,12,Cobra 08,1118,11/2/21
63,1,5,0,6,RECON 01,1109,11/2/21
64,2,5,1,8,CRAZE 34,1115,11/2/21
65,1,5,2,8,SPOT 91,1124,11/2/21
66,1,5,2,8,DRAGN 25,1133,11/2/21
67,0,1,3,4,DRAGN 81,1130,11/2/21
68,1,5,0,6,STAB 21,1136,11/2/21
69,2,6,1,9,AMMO 01,1206,11/2/21
70,1,5,1,7,DRAGN 33,1209,11/2/21
71,2,5,1,8,AMMO 02,1251,11/2/21
72,0,5,1,6,AMMO 05,1245,11/2/21
73,0,6,3,9,AMMO 08,1248,11/2/21
74,1,6,0,7,WIRE 31,1257,11/2/21
75,1,6,2,9,WIRE 31,1300,11/2/21
76,0,6,3,9,CRAZE 16,1306,11/2/21
77,0,7,4,11,RECON 74,1315,11/2/21
78,1,6,0,7,BADGR 01,1318,11/2/21
79,2,9,4,15,DRAGN 66,1324,11/2/21
80,4,5,2,11,DRAGN 65,1327,11/2/21
81,0,7,3,10,HOOK46,1412,11/2/21
82,1,5,2,8,DRAGN86,1445,11/2/21
83,1,7,0,8,SHINR81,1436,11/2/21
84,1,7,0,8,SHINR82,1439,11/2/21
85,2,5,2,9,DAWG09,1554,11/2/21
86,1,4,4,9,DAWG05,1600,11/2/21
87,0,5,3,8,DRAGN54,1609,11/2/21
88,1,5,4,10,DRAGN09,1415,11/2/21
89,1,5,0,6,DRAGN22,1615,11/2/21
90,2,5,4,11,COACH21,1621,11/2/21
91,2,5,4,11,COACH22,1624,11/2/21
92,1,4,2,7,RECON08,1612,11/2/21
93,0,5,2,7,AMMO02,815,11/3/21
94,1,7,2,10,GOLEM31,909,11/3/21
95,1,7,5,13,GOLEM32,912,11/3/21
96,1,5,4,10,COACH21,851,11/3/21
97,1,5,4,10,COACH22,854,11/3/21
98,0,8,2,10,LOADED1,927,11/3/21
99,3,4,1,8,LOADED2,930,11/3/21
100,0,6,3,9,DRAGN66,945,11/3/21
101,0,6,3,9,RECON08,939,11/3/21
102,0,8,4,12,CRAZE11,1036,11/3/21
103,1,5,1,7,STAB11,1015,11/3/21
104,1,5,1,7,STAB12,1018,11/3/21
105,1,8,0,9,TAUNT81,915,11/3/21
106,1,8,2,11,TAUNT82,918,11/3/21
107,0,5,0,5,RECON73,1136,11/3/21
108,0,6,1,7,SPECK53,1239,11/3/21
109,0,4,0,4,AMMO01,1312,11/3/21
110,0,4,0,4,PHNTM99,1318,11/3/21
111,2,3,0,5,DRAGN17,1336,11/3/21
112,2,5,1,8,DRAGN48,1321,11/3/21
113,0,3,2,5,CRAZE22,1324,11/3/21
114,0,5,0,5,BALL19,1315,11/3/21
115,0,2,0,2,RECON07,1333,11/3/21
116,2,5,4,11,DRAGN16,1330,11/3/21
117,0,1,2,3,CRAZE79,1327,11/3/21
118,1,2,1,4,CREEP31,1400,11/3/21
119,1,3,0,4,CREEP32,1403,11/3/21
120,0,3,6,9,BALL41,1442,11/3/21
121,1,3,2,6,VEGA21,1406,11/3/21
122,1,3,2,6,VEGA22,1409,11/3/21
123,1,5,2,8,AXLE11,1412,11/3/21
124,1,5,1,7,AXLE12,1415,11/3/21
125,1,2,2,5,WIRE31,1418,11/3/21
126,1,2,4,7,WIRE32,1421,11/3/21
127,0,6,6,12,DRAGN52,1433,11/3/21
128,1,2,3,6,SHINR81,1436,11/3/21
129,1,2,4,7,SHINR82,1439,11/3/21
130,1,1,3,5,SPOT91,1548,11/3/21
131,1,1,0,2,SPOT92,1551,11/3/21
132,1,4,3,8,STAB11,1554,11/3/21
133,1,4,8,13,STAB12,1557,11/3/21
134,1,3,2,6,HANG51,1539,11/3/21
135,1,3,3,7,HANG52,1542,11/3/21
136,0,3,0,3,DRAGN73,1536,11/3/21
137,0,2,2,4,AMMO02,803,11/4/21
138,0,2,1,3,RECON87,800,11/4/21
139,0,2,3,5,CRAZE76,806,11/4/21
140,1,3,3,7,AXLE11,830,11/4/21
141,1,3,4,8,AXLE11,830,11/4/21
142,1,2,3,6,AMMO01,809,11/4/21
143,0,2,0,2,CRAZE16,812,11/4/21
144,1,1,2,4,BADGR05,815,11/4/21
145,1,2,3,6,PHNTM45,836,11/4/21
146,1,3,2,6,GOLEM31,845,11/4/21
147,1,3,6,10,GOLEM31,845,11/4/21
148,1,4,3,8,GIZMO51,851,11/4/21
149,1,4,4,9,GIZMO51,851,11/4/21
150,0,2,1,3,BALL29,827,11/4/21
151,0,4,2,6,TAUNT12,900,11/4/21
152,1,2,3,6,LOST11,918,11/4/21
153,1,2,3,6,LOST11,918,11/4/21
154,1,6,2,9,LOADED01,903,11/4/21
155,1,6,1,8,LOADED01,903,11/4/21
156,0,5,2,7,BALL08,909,11/4/21
157,0,3,6,9,OUZO11,800,11/4/21
158,1,2,2,5,SHINR81,936,11/4/21
159,1,2,1,4,SHINR82,936,11/4/21
160,1,3,3,7,LOOKER01,930,11/4/21
161,1,3,0,4,LOOKER01,930,11/4/21
162,0,2,3,5,TORA11,918,11/4/21
163,0,2,1,3,TORA12,921,11/4/21
164,0,1,2,3,DRAGN44,948,11/4/21
165,2,2,1,5,DRAGN48,951,11/4/21
166,0,4,2,6,TAUNT11,857,11/4/21
167,2,1,2,5,DRAGN59,954,11/4/21
168,1,1,4,6,DRAGN16,1000,11/4/21
169,2,3,0,5,COACH21,1009,11/4/21
170,2,3,0,5,COACH21,1012,11/4/21
171,0,1,2,3,HOOK38,924,11/4/21
172,0,4,1,5,BALL51,1018,11/4/21
173,0,1,0,1,BALL02,1030,11/4/21
174,0,2,0,2,DAWG09,1036,11/4/21
175,0,3,0,3,FURY02,1036,11/4/21
176,2,3,2,7,TORA21,1030,11/4/21
177,2,3,2,7,TORA22,1030,11/4/21
178,2,3,2,7,BALL45,1039,11/4/21
179,2,1,1,4,LOOT50,1033,11/4/21
180,0,4,4,8,SPECK48,1042,11/4/21
181,1,2,2,5,RENO71,1003,11/4/21
182,1,3,3,7,WIRE31,1100,11/4/21
183,1,3,0,4,WIRE31,1100,11/4/21
184,2,2,1,5,RECON73,1112,11/4/21
185,1,2,0,3,AXLE11,1115,11/4/21
186,1,2,2,5,AXLE11,1118,11/4/21
187,0,2,4,6,COBRA08,1106,11/4/21
188,1,4,5,10,DRAGN86,1121,11/4/21
189,0,1,1,2,CRAZE34,1109,11/4/21
190,0,1,4,5,EVIL02,1130,11/4/21
191,2,1,2,5,STAB11,1133,11/4/21
192,0,1,1,2,CRAZY21,1124,11/4/21
193,1,3,2,6,BALL58,1236,11/4/21
194,2,0,0,2,SPOT91,1242,11/4/21
195,1,0,2,3,SPOT,92,11/4/21
196,3,2,1,6,GHOST02,1248,11/4/21
197,0,1,5,6,CRAZE79,1239,11/4/21
198,1,3,1,5,ETCH41,1254,11/4/21
199,1,3,2,6,ETCH42,1254,11/4/21
200,2,3,0,5,EVIL01,1303,11/4/21
201,1,3,1,5,HANG51,1309,11/4/21
202,1,3,1,5,HANG52,1309,11/4/21
203,0,3,1,4,BALL02,1306,11/4/21
204,0,3,2,5,HOOK07,1300,11/4/21
205,2,3,6,11,GIZMO21,1315,11/4/21
206,2,3,1,6,GIZMO22,1321,11/4/21
207,0,1,0,1,CRAZE28,1327,11/4/21
208,1,1,2,4,DRAGN42,1333,11/4/21
209,1,3,3,7,CRAZE22,1324,11/4/21
210,1,1,3,5,RECON75,1324,11/4/21
211,0,1,1,2,DRAGN05,1318,11/4/21
212,2,2,2,6,DRAGN51,1403,11/4/21
213,2,2,1,5,PAWS33,1400,11/4/21
214,0,1,3,4,HOOK52,1045,11/4/21
215,3,2,3,8,BALL45,1409,11/4/21
216,2,1,5,8,DRAGN54,1412,11/4/21
217,1,0,4,5,VEGA21,1421,11/4/21
218,1,0,1,2,VEGA22,1424,11/4/21
219,1,1,0,2,COACH21,1415,11/4/21
220,1,1,0,2,COACH22,1418,11/4/21
221,1,0,4,5,WIRE31,1427,11/4/21
222,1,0,4,5,WIRE32,1430,11/4/21
223,0,2,4,6,FURY02,1433,11/4/21
224,0,0,2,2,DRAGN62,1406,11/4/21
225,2,0,3,5,RECON73,1436,11/4/21
226,0,0,0,0,D,0,11/4/21
227,1,1,3,5,BALL41,1442,11/4/21
228,1,2,1,4,DAWG09,1539,11/4/21
229,2,1,5,8,ETCH41,1600,11/4/21
230,2,1,3,6,ETCH42,1603,11/4/21
231,1,0,2,3,PHNTM50,1542,11/4/21
232,3,2,1,6,DAWG04,1345,11/4/21
233,2,1,2,5,CRAZE34,1557,11/4/21
234,2,2,4,8,COBRA06,1551,11/4/21
235,2,1,2,5,BALL82,1548,11/4/21
236,0,0,4,4,COBRA01,1554,11/4/21
237,1,2,4,7,AXLE11,1606,11/4/21
238,1,2,3,6,AXLE12,1609,11/4/21
239,2,2,1,5,RENO71,1615,11/4/21
240,2,2,0,4,RENO72,1618,11/4/21
241,1,1,0,2,BALL69,803,11/5/21
242,1,2,1,4,SPOT91,812,11/5/21
243,1,2,0,3,SPOT92,815,11/5/21
244,0,3,2,5,HOOK07,821,11/5/21
245,1,2,0,3,EASY86,801,11/5/21
246,1,3,4,8,SHINR81,836,11/5/21
247,1,3,3,7,SHINR82,839,11/5/21
248,1,2,1,4,PHANTM45,830,11/5/21
249,2,4,4,10,RHINO99,800,11/5/21
250,1,2,2,5,EASY42,831,11/5/21
251,2,4,3,9,DRAGN48,851,11/5/21
252,1,2,3,6,EASY89,802,11/5/21
253,1,2,1,4,EASY85,804,11/5/21
254,1,2,2,5,COACH21,845,11/5/21
255,1,2,1,4,COACH22,848,11/5/21
256,2,1,2,5,DRAGN65,833,11/5/21
257,2,4,3,9,CRAZE44,842,11/5/21
258,2,3,3,8,CRAZE46,854,11/5/21
259,2,1,2,5,RECON73,857,11/5/21
260,1,0,3,4,GHOST01,906,11/5/21
261,1,2,1,4,DRAGN07,821,11/5/21
262,2,4,0,6,TAUNT81,900,11/5/21
263,2,3,2,7,TAUNT82,903,11/5/21
264,0,3,0,3,PAWS21,909,11/5/21
265,2,4,3,9,STAB11,921,11/5/21
266,2,4,6,12,STAB12,924,11/5/21
267,0,4,3,7,CRAZE22,942,11/5/21
268,1,2,3,6,DAWG05,927,11/5/21
269,3,2,1,6,SMALL17,933,11/5/21
270,1,2,1,4,GIZMO11,915,11/5/21
271,1,2,1,4,GIZMO12,918,11/5/21
272,1,1,2,4,DRAGN66,912,11/5/21
273,1,3,1,5,RENO71,948,11/5/21
274,3,3,0,6,RENO72,951,11/5/21
275,4,3,1,8,PHNTM99,945,11/5/21
276,1,3,1,5,AXLE11,924,11/5/21
277,1,3,1,5,AXLE12,927,11/5/21
278,2,2,0,4,DAWG09,1009,11/5/21
279,1,0,5,6,WIRE31,1000,11/5/21
280,1,0,2,3,WIRE31,1003,11/5/21
281,1,0,1,2,DAWG04,1006,11/5/21
282,4,1,0,5,SMALL34,1012,11/5/21
283,0,2,2,4,HOOK52,936,11/5/21
284,1,0,2,3,EASY86,946,11/5/21
285,3,2,0,5,LOOT50,1012,11/5/21
286,1,2,3,6,HANG51,1018,11/5/21
287,1,2,1,4,HANG52,1021,11/5/21
288,1,3,1,5,DRAGN83,1030,11/5/21
289,3,1,1,5,CRAZE79,1027,11/5/21
290,0,2,3,5,RECON82,1024,11/5/21
291,1,2,0,3,DRAGN09,1039,11/5/21
292,1,2,3,6,CREEP31,1033,11/5/21
293,1,2,3,6,CREEP32,1036,11/5/21
294,2,1,2,5,EVIL02,1106,11/5/21
295,1,0,4,5,DRAGN39,1243,11/5/21
296,3,0,1,4,CRAZE33,1254,11/5/21
297,1,0,0,1,POST61,1257,11/5/21
298,1,0,0,1,POST62,1257,11/5/21
299,1,1,4,6,EASY89,1733,11/5/21
300,3,2,2,7,RECON07,1318,11/5/21
301,2,0,3,5,SCARE99,1351,11/5/21
302,1,0,4,5,RECON75,1333,11/5/21
303,0,0,3,3,CRAZE76,1337,11/5/21
304,4,,2,,SCARE71,1330,11/5/21
305,2,2,1,5,BALL05,1339,11/5/21
306,0,0,2,2,DRAGN73,1351,11/5/21
307,0,1,4,5,DRAGN77,1354,11/5/21
308,0,2,3,5,HOOK69,0,11/5/21
309,2,0,2,4,STAB11,1345,11/5/21
310,2,0,3,5,STAB12,1345,11/5/21
311,2,2,3,7,CRAZE46,1332,11/5/21
312,2,2,4,8,LOADED1,1412,11/5/21
313,3,2,4,9,LOADED2,1412,11/5/21
314,0,0,1,1,CRAZY28,1427,11/5/21
315,2,1,2,5,HANG51,1245,11/5/21
316,2,1,7,10,HANG52,1245,11/5/21
317,2,0,2,4,DRAGN17,1309,11/5/21
318,2,0,3,5,RECON73,1257,11/5/21
319,1,0,1,2,BALL69,1303,11/5/21
320,1,2,1,4,RECON08,1300,11/5/21
321,0,0,8,8,DRAGN71,1321,11/5/21
322,4,2,0,6,HOOK01,1306,11/5/21
323,1,2,0,3,VEGA21,1330,11/5/21
324,1,2,0,3,VEGA22,1333,11/5/21
325,0,0,2,2,DRAGN05,1315,11/5/21
326,0,2,3,5,BALL19,1333,11/5/21
327,1,0,3,4,POST51,1324,11/5/21
328,1,0,2,3,POST52,1327,11/5/21
329,2,3,2,7,AXEL11,1415,11/5/21
330,1,3,1,5,AXEL12,1415,11/5/21
331,3,1,0,4,RAGTAG1,1409,11/5/21
332,3,1,0,4,RAGTAG2,1415,11/5/21
333,2,0,3,5,DAWG02,1436,11/5/21
334,0,0,0,0,DAWG01,1433,11/5/21
335,2,0,1,3,GHOST02,1445,11/5/21
336,1,0,5,6,BALL29,1442,11/5/21
337,2,2,4,8,COBRA01,1451,11/5/21
338,1,0,1,2,EVIL01,1445,11/5/21
339,1,0,3,4,FILL81,1424,11/5/21
340,1,0,3,4,FILL82,1427,11/5/21
341,1,1,3,5,COACH21,1457,11/5/21
342,1,1,3,5,COACH22,1500,11/5/21
343,1,0,2,3,HANG51,1503,11/5/21
344,1,0,0,1,HANG52,1506,11/5/21
345,2,0,6,8,SCARE15,1448,11/5/21
346,3,0,1,4,RECON01,1454,11/5/21
347,2,0,7,9,DRAGN38,1530,11/5/21
348,2,0,0,2,SMALL17,1533,11/5/21
349,2,2,5,9,DRAGN39,1527,11/5/21
350,1,0,1,2,AMMO02,1545,11/5/21
351,1,0,1,2,SCARE76,1548,11/5/21
352,1,1,3,5,AMMO08,1542,11/5/21
353,0,0,4,4,HOOK44,1524,11/5/21
354,1,0,2,3,SCARE75,1551,11/5/21
355,0,0,2,2,BALL07,1512,11/5/21
356,1,2,2,5,HOOK86,1600,11/5/21
357,2,2,3,7,HOOK67,1618,11/5/21
358,1,2,0,3,HOOK35,1630,11/5/21
359,1,0,2,3,TORA11,1554,11/5/21
360,1,0,4,5,TORA12,1557,11/5/21
361,4,4,2,10,Dragon17,733,11/8/21
362,0,3,2,5,CRAZE22,736,11/8/21
363,1,3,7,11,CRAZE42,742,11/8/21
364,0,5,5,10,HOOK44,730,11/8/21
365,1,4,5,10,WIRE31,745,11/8/21
366,2,4,4,10,WIRE32,748,11/8/21
367,2,3,4,9,PHANTOM51,739,11/8/21
368,1,5,5,11,VEGA21,757,11/8/21
369,1,5,6,12,VEGA22,800,11/8/21
370,0,5,5,10,EPIPC02,754,11/8/21
371,2,0,5,7,COBRA08,818,11/8/21
372,1,3,5,9,STAB11,812,11/8/21
373,1,3,5,9,STAB12,815,11/8/21
374,0,5,3,8,PAWS43,803,11/8/21
375,1,2,2,5,GIZMO11,806,11/8/21
376,1,2,2,5,GIZMO12,809,11/8/21
377,2,3,4,9,COBRA05,827,11/8/21
378,1,1,5,7,DAWG02,824,11/8/21
379,1,3,5,9,DAWG09,827,11/8/21
380,3,2,3,8,BALL44,830,11/8/21
381,0,2,5,7,PAWS07,854,11/8/21
382,2,3,2,7,DAWG05,833,11/8/21
383,2,3,5,10,COAH21,836,11/8/21
384,2,3,3,8,COACH22,839,11/8/21
385,1,2,4,7,AXLE21,848,11/8/21
386,1,2,4,7,AXLE22,851,11/8/21
387,2,0,3,5,DRAGN52,751,11/8/21
388,2,3,5,10,DRAGN41,903,11/8/21
389,2,2,4,8,DRAGN77,857,11/8/21
390,1,3,1,5,RECON69,906,11/8/21
391,2,2,3,7,DRAGN03,900,11/8/21
392,1,4,3,8,EASY89,850,11/8/21
393,3,3,0,6,RECON08,909,11/8/21
394,2,3,6,11,BALL32,912,11/8/21
395,4,4,6,14,LOADED1,948,11/8/21
396,4,4,5,13,LOADED2,951,11/8/21
397,2,2,3,7,HANG51,942,11/8/21
398,2,2,2,6,HANG52,945,11/8/21
399,1,3,5,9,TORA91,936,11/8/21
400,1,3,5,9,TORA92,939,11/8/21
401,0,1,4,5,HOODOO2,933,11/8/21
402,1,5,1,7,LOOKER1,915,11/8/21
403,1,5,3,9,LOOKER2,918,11/8/21
404,4,5,1,10,TORA51,954,11/8/21
405,4,5,0,9,TORA52,957,11/8/21
406,2,2,3,7,WIRE31,1000,11/8/21
407,2,2,3,7,WIRE32,1003,11/8/21
408,2,0,1,3,CRAZE77,1036,11/8/21
409,1,3,1,5,LOST11,1006,11/8/21
410,1,3,0,4,LOST12,1009,11/8/21
411,1,3,3,7,ETCH41,1030,11/8/21
412,1,3,6,10,ETCH42,1033,11/8/21
413,1,3,0,4,CRAZE16,1039,11/8/21
414,1,5,1,7,CRAZE54,1042,11/8/21
415,2,3,2,7,SPOT91,1045,11/8/21
416,2,3,2,7,SPOT92,1048,11/8/21
417,3,4,0,7,LOST81,924,11/8/21
418,3,4,2,9,LOST82,927,11/8/21
419,2,2,0,4,PHNTM99,1106,11/8/21
420,0,3,4,7,CRAZE28,1109,11/8/21
421,0,5,8,13,HOOK44,1103,11/8/21
422,0,3,4,7,HOOK81,1112,11/8/21
423,2,4,7,13,DRAGN52,1121,11/8/21
424,1,4,3,8,EASY89,1115,11/8/21
425,4,4,6,14,DRAGON51,1118,11/8/21
426,0,0,1,1,CRAZE55,1051,11/8/21
427,4,5,3,12,STAB11,1127,11/8/21
428,2,5,4,11,STAB11,1127,11/8/21
429,1,2,4,7,AXLE11,1145,11/8/21
430,3,2,3,8,AXLE12,1148,11/8/21
431,1,1,5,7,DRAGN54,1124,11/8/21
432,1,0,2,3,GIZMO11,1139,11/8/21
433,1,0,2,3,GIZMO12,1142,11/8/21
434,1,4,3,8,CREEP31,1154,11/8/21
435,1,4,1,6,CREEP32,1154,11/8/21
436,1,2,4,7,AXLE11,1145,11/8/21
437,3,2,3,8,AXLE12,1148,11/8/21
438,2,1,2,5,CRAZE41,1151,11/8/21
439,2,1,6,9,DAWG02,1200,11/8/21
440,2,3,4,9,DAWG09,1203,11/8/21
441,0,3,3,6,RECON07,1206,11/8/21
442,3,3,6,12,BALL05,1209,11/8/21
443,3,2,3,8,Ball81,1333,11/8/21
444,1,1,4,6,Coach21,1348,11/8/21
445,1,1,2,4,coach22,1351,11/8/21
446,0,3,0,3,Recon88,1330,11/8/21
447,3,2,3,8,Ball69,1336,11/8/21
448,1,2,4,7,DRAGN22,1354,11/8/21
449,1,1,1,3,PHNTM55,1339,11/8/21
450,2,1,1,4,SMALL55,1403,11/8/21
451,2,2,1,5,CRAZE79,1342,11/8/21
452,0,3,3,6,CRAZE21,1357,11/8/21
453,4,2,3,9,CRAZE77,1412,11/8/21
454,4,2,3,9,DRAGN41,1415,11/8/21
455,0,3,7,10,HOOK67,1409,11/8/21
456,1,3,4,8,DRAGN72,1400,11/8/21
457,3,0,1,4,Small65,1427,11/8/21
458,3,3,1,7,DRAGN33,1406,11/8/21
459,0,3,2,5,BADGR05,1421,11/8/21
460,0,0,0,0,RECON77,1418,11/8/21
461,0,0,2,2,BADGR09,1424,11/8/21
462,1,4,1,6,DRAGN83,1430,11/8/21
463,1,3,1,5,Ball28,1433,11/8/21
464,0,1,3,4,LOOT69,1439,11/8/21
465,0,1,4,5,AMMO08,1445,11/8/21
466,1,1,6,8,RECON75,1436,11/8/21
467,0,1,2,3,AMMO05,1442,11/8/21
468,1,1,2,4,AMMO02,1454,11/8/21
469,0,1,2,3,RECON89,1448,11/8/21
470,0,0,3,3,DRAGN51,1451,11/8/21
471,1,0,2,3,RECON07,1733,11/8/21
472,1,0,4,5,BADGR07,1730,11/8/21
473,1,0,5,6,RECON71,1718,11/8/21
474,1,0,5,6,HANG51,730,11/9/21
475,1,0,6,7,HANG52,730,11/9/21
476,0,3,3,6,DRAGN77,736,11/9/21
477,2,3,3,8,DRAGN81,739,11/9/21
478,0,1,6,7,PHNTM51,745,11/9/21
479,0,3,3,6,DRAGN51,742,11/9/21
480,1,2,8,11,DRAGN04,748,11/9/21
481,2,2,4,8,GOLEM11,757,11/9/21
482,2,2,5,9,GOLEM12,757,11/9/21
483,1,3,5,9,COACH21,751,11/9/21
484,1,3,6,10,COACH52,751,11/9/21
485,3,2,3,8,BALL84,806,11/9/21
486,1,3,7,11,STAB11,809,11/9/21
487,3,3,6,12,STAB12,809,11/9/21
488,2,2,7,11,COBRA08,824,11/9/21
489,2,2,4,8,COBRA05,821,11/9/21
490,2,2,4,8,COBRA02,818,11/9/21
491,3,2,7,12,COBRA01,815,11/9/21
492,1,3,7,11,FURY02,803,11/9/21
493,1,1,3,5,DAWG02,827,11/9/21
494,1,2,2,5,DAWG04,833,11/9/21
495,1,2,4,7,GHOST48,830,11/9/21
496,1,2,4,7,RECON05,836,11/9/21
497,2,2,6,10,SMALL74,848,11/9/21
498,0,3,4,7,DRAGN21,845,11/9/21
499,1,3,2,6,VEGA21,839,11/9/21
500,1,3,2,6,VEGA22,842,11/9/21
501,1,3,0,4,DRAGN73,857,11/9/21
502,2,3,4,9,BALL69,900,11/9/21
503,0,2,0,2,HOOK99,851,11/9/21
504,2,2,2,6,LOOKER1,903,11/9/21
505,2,2,3,7,LOOKER2,906,11/9/21
506,2,2,6,10,DRAGN24,854,11/9/21
507,2,3,2,7,SLOW81,909,11/9/21
508,1,3,4,8,SLOW82,912,11/9/21
509,2,3,4,9,TAUNT11,927,11/9/21
510,2,3,3,8,TAUNT12,930,11/9/21
511,0,2,5,7,BUBO32,933,11/9/21
512,3,3,3,9,TORA21,924,11/9/21
513,1,3,3,7,TORA22,927,11/9/21
514,2,3,4,9,TORA11,918,11/9/21
515,2,3,0,5,TORA12,918,11/9/21
516,0,2,2,4,DAWG05,976,11/9/21
517,3,3,1,7,SLOW51,951,11/9/21
518,2,3,5,10,SLOW52,954,11/9/21
519,1,4,2,7,LOADED1,1127,11/9/21
520,1,4,3,8,LOADED2,945,11/9/21
521,0,2,4,6,DRAGN41,1030,11/9/21
522,2,3,1,6,CRAZE77,1036,11/9/21
523,0,2,2,4,DRAGN03,1033,11/9/21
524,2,2,4,8,ETCH41,1039,11/9/21
525,2,2,4,8,ETCH42,1042,11/9/21
526,2,3,0,5,BADGR02,1048,11/9/21
527,1,2,1,4,AMMO02,1054,11/9/21
528,0,2,4,6,AMMO08,1100,11/9/21
529,1,3,3,7,POST61,1045,11/9/21
530,1,3,1,5,POST62,1051,11/9/21
531,1,3,2,6,SCARE05,1115,11/9/21
532,0,2,0,2,BALL15,1103,11/9/21
533,0,3,1,4,CRAZE16,1112,11/9/21
534,3,2,6,11,CRAZE42,1124,11/9/21
535,0,3,7,10,DRAGN,1109,11/9/21
536,0,3,3,6,CRAZE55,1057,11/9/21
537,0,1,6,7,DRAGN58,1121,11/9/21
538,0,2,3,5,PHNTM51,1118,11/9/21
539,2,2,2,6,TAUNT81,1127,11/9/21
540,2,2,0,4,TAUNT82,1130,11/9/21
541,2,2,5,9,CREEP31,1133,11/9/21
542,2,2,0,4,CREEP32,1136,11/9/21
543,3,2,2,7,GHOST02,1151,11/9/21
544,1,2,5,8,AXEL11,1139,11/9/21
545,1,2,6,9,AXLE12,1142,11/9/21
546,2,3,7,12,TORA31,1154,11/9/21
547,2,3,7,12,TORA32,1157,11/9/21
548,2,2,4,8,GIZMO51,945,11/9/21
549,2,2,4,8,GIMZO52,948,11/9/21
550,1,2,5,8,WIRE31,1145,11/9/21
551,1,2,7,10,WIRE32,1148,11/9/21
552,1,2,3,6,RECON05,1206,11/9/21
553,1,3,4,8,DAWG09,1203,11/9/21
554,3,2,5,10,DAWG05,1200,11/9/21
555,1,1,3,5,DAWG04,1342,11/9/21
556,1,2,2,5,VEGA21,1345,11/9/21
557,1,2,7,10,VEGA22,1348,11/9/21
558,1,2,3,6,HANG51,1333,11/9/21
559,1,2,2,5,HANG52,1336,11/9/21
560,0,0,1,1,DRAGN72,1406,11/9/21
561,0,2,4,6,BALL02,1339,11/9/21
562,1,1,3,5,PAWS07,1330,11/9/21
563,1,0,3,4,COACH21,1400,11/9/21
564,1,0,3,4,COACH22,1403,11/9/21
565,0,1,3,4,DRAGN51,1351,11/9/21
566,1,2,1,4,RENO21,1354,11/9/21
567,1,2,2,5,RENO22,1357,11/9/21
568,2,2,1,5,DRAGN73,1409,11/9/21
569,3,0,2,5,SMALL62,1418,11/9/21
570,4,2,6,12,DRAGN44,1421,11/9/21
571,2,2,4,8,DRAGN66,1415,11/9/21
572,0,2,3,5,BADGR07,1424,11/9/21
573,0,0,3,3,BADGR08,1427,11/9/21
574,2,2,2,6,BADGR02,1433,11/9/21
575,1,2,1,4,SLOW72,1442,11/9/21
576,0,2,1,3,AMMO02,1439,11/9/21
577,1,2,2,5,BADGR01,1430,11/9/21
578,0,2,6,8,BALL75,1436,11/9/21
579,3,2,3,8,CRAZE16,1451,11/9/21
580,2,0,2,4,AXLE11,1445,11/9/21
581,2,0,6,8,AXEL12,1448,11/9/21
582,1,2,6,9,ETCH41,1454,11/9/21
583,3,2,1,6,ETCH42,1457,11/9/21
584,2,2,0,4,HOOK01,1700,11/9/21
585,2,2,1,5,BALL51,1727,11/9/21
586,1,0,0,1,CRAZE13,1730,11/9/21
587,1,0,0,1,LOOT42,1733,11/9/21
588,1,0,0,1,AMMO09,1736,11/9/21
589,2,2,1,5,LOOT55,1739,11/9/21
590,2,8,5,15,Lost21,945,11/10/21
591,1,6,4,11,Ball02,1003,11/10/21
592,1,7,5,13,Fury07,1015,11/10/21
593,1,2,5,8,Ball38,921,11/10/21
594,0,2,1,3,Ball73,924,11/10/21
595,1,7,3,11,Paws43,1136,11/10/21
596,2,7,5,14,Hook22,1030,11/10/21
597,2,3,3,8,Dragn66,1033,11/10/21
598,1,2,1,4,Craze16,1039,11/10/21
599,2,2,2,6,Dragn69,1033,11/10/21
600,0,4,2,6,Ball 45,1051,11/10/21
601,1,2,0,3,Paws13,1100,11/10/21
602,3,1,7,11,Hook67,1117,11/10/21
603,0,3,2,5,PAWS07,1357,11/10/21
604,0,3,0,3,BALL19,1145,11/10/21
605,1,9,3,13,POST61,1148,11/10/21
606,0,4,4,8,FURY01,1154,11/10/21
607,0,5,0,5,PAWS14,1142,11/10/21
608,1,5,3,9,DAWG02,1336,11/10/21
609,1,4,0,5,DAWG09,1333,11/10/21
610,1,4,3,8,DAWG04,1330,11/10/21
611,0,2,4,6,GHOST53,1342,11/10/21
612,1,7,4,12,CRAZE11,1351,11/10/21
613,1,4,4,9,DRAGN66,1427,11/10/21
614,1,3,3,7,HOOK03,1415,11/10/21
615,0,4,4,8,PHNTM45,1424,11/10/21
616,0,5,2,7,DRAGN33,1418,11/10/21
617,0,6,6,12,AMMO08,1503,11/10/21
618,,,,,,0,11/10/21
619,2,5,4,11,DRAGN48,736,11/12/21
620,3,3,5,11,DRAGN77,739,11/12/21
621,0,7,6,13,CRAZE42,748,11/12/21
622,0,0,0,0,,7,11/12/21
623,0,0,0,0,DRAGN51,0,11/12/21
624,0,0,0,0,DRA,0,11/12/21
625,2,5,8,15,DRAGN51,745,11/12/21
626,0,5,4,9,BALL67,754,11/12/21
627,1,7,4,12,DRAGN59,742,11/12/21
628,1,4,7,12,VEGA21,757,11/12/21
629,0,6,1,7,RECON89,751,11/12/21
630,2,1,4,7,GHOST69,809,11/12/21
631,1,3,7,11,STAB11,803,11/12/21
632,3,3,4,10,STAB12,806,11/12/21
633,2,1,6,9,COBRA05,815,11/12/21
634,1,2,1,4,PAWS13,839,11/12/21
635,2,5,3,10,SLOW51,824,11/12/21
636,1,5,1,7,SLOW52,827,11/12/21
637,3,1,3,7,BALL44,833,11/12/21
638,2,3,4,9,RECON01,818,11/12/21
639,3,4,3,10,PHNTM50,821,11/12/21
640,1,3,3,7,GHOST48,830,11/12/21
641,2,3,1,6,RECON69,836,11/12/21
642,0,3,1,4,RHINO99,800,11/12/21
643,1,5,2,8,AXLE41,851,11/12/21
644,1,5,6,12,AXLE42,854,11/12/21
645,2,3,4,9,COACH21,857,11/12/21
646,2,3,4,9,COACH22,900,11/12/21
647,2,2,6,10,STAB51,845,11/12/21
648,1,2,2,5,STAB52,848,11/12/21
649,0,5,0,5,DRAGN69,915,11/12/21
650,1,2,1,4,GHOST02,903,11/12/21
651,3,2,4,9,DAWG02,912,11/12/21
652,0,2,1,3,DRAGN05,842,11/12/21
653,2,8,3,13,SLOW21,930,11/12/21
654,1,8,3,12,SLOW22,933,11/12/21
655,2,4,6,12,BALL82,924,11/12/21
656,1,5,2,8,LOADED1,936,11/12/21
657,1,5,2,8,LOADED2,939,11/12/21
658,4,5,3,12,CRAZE46,927,11/12/21
659,1,1,1,3,CRAZE21,918,11/12/21
660,4,3,2,9,PHANTOM45,1033,11/12/21
661,2,6,4,12,CREEP31,1036,11/12/21
662,2,2,1,5,HOOK65,1042,11/12/21
663,1,4,0,5,BADGR05,1045,11/12/21
664,0,0,0,0,PNTM69,1051,11/12/21
665,0,4,0,4,PAWS16,1048,11/12/21
666,4,7,3,14,AXLE11,1109,11/12/21
667,0,3,2,5,BALL07,1100,11/12/21
668,0,2,3,5,AMMO08,1106,11/12/21
669,0,2,3,5,RECON89,1136,11/12/21
670,2,3,0,5,PAWS76,1103,11/12/21
671,0,5,0,5,PAWS43,1133,11/12/21
672,2,2,1,5,LOOKER1,1118,11/12/21
673,0,4,3,7,DRAGN51,1130,11/12/21
674,1,5,3,9,POST61,1145,11/12/21
675,2,6,7,15,GIZMO11,1145,11/12/21
676,1,2,4,7,DAWG04,1206,11/12/21
677,4,3,5,12,WIRED31,1157,11/12/21
678,1,2,3,6,DAWG05,1203,11/12/21
679,2,5,4,11,CRAZE09,1215,11/12/21
680,4,4,4,12,VEGA21,1218,11/12/21
681,3,2,4,9,DAWG02,1209,11/12/21
682,2,3,3,8,RECON08,1154,11/12/21
683,2,4,3,9,recon69,1339,11/12/21
684,1,4,2,7,ball81,1336,11/12/21
685,2,2,2,6,DAWG09,1332,11/12/21
686,1,4,4,9,DRAGN48,1354,11/12/21
687,2,3,1,6,BADGR05,1400,11/12/21
688,1,4,1,6,DRAGN14,1357,11/12/21
689,1,4,3,8,ETCH41,1406,11/12/21
690,3,4,5,12,ETCH41,1409,11/12/21
691,3,4,3,10,DRAGN66,1412,11/12/21
692,4,2,2,8,PHNTM45,1415,11/12/21
693,1,4,1,6,EASY86,1411,11/12/21
694,0,2,2,4,HOOK16,1342,11/12/21
695,0,2,3,5,HOOK16,1342,11/12/21
696,1,2,0,3,HOOK36,1351,11/12/21
697,1,2,2,5,EASY85,1410,11/12/21
698,1,2,2,5,AMMO02,1436,11/12/21
699,0,4,2,6,PHNTM69,1403,11/12/21
700,2,4,6,12,TORA21,1448,11/12/21
701,2,4,4,10,TORA22,1451,11/12/21
702,2,2,5,9,WIRE31,1439,11/12/21
703,2,2,2,6,WIRE31,1442,11/12/21
704,2,2,3,7,TAUNT21,1345,11/12/21
705,1,2,4,7,TAUNT22,1348,11/12/21
706,1,3,0,4,TORA81,1454,11/12/21
707,1,2,0,3,TORA81,1457,11/12/21
708,0,2,1,3,HOOK73,1518,11/12/21
709,1,4,2,7,GOLEM21,1506,11/12/21
710,0,6,0,6,GIZMO52,1503,11/12/21
711,0,3,0,3,GIZMO51,1512,11/12/21
712,1,4,1,6,GOLEM22,1503,11/12/21
713,0,4,1,5,HOOK03,1521,11/12/21
714,1,3,1,5,loaded1,1445,11/12/21
715,4,3,0,7,ball21,1430,11/12/21
716,3,3,2,8,ball22,1427,11/12/21
717,3,3,0,6,ball27,1433,11/12/21
718,3,3,1,7,ball29,1424,11/12/21
719,1,2,6,9,STAB11,706,11/15/21
720,1,2,9,12,STAB12,706,11/15/21
721,1,2,4,7,VEGA21,700,11/15/21
722,2,2,7,11,VEGA22,703,11/15/21
723,1,3,1,5,SPOT91,712,11/15/21
724,1,3,7,11,SPOT92,715,11/15/21
725,0,2,7,9,HOOK83,718,11/15/21
726,2,2,6,10,COBRA05,730,11/15/21
727,2,2,8,12,COBRA02,724,11/15/21
728,1,0,4,5,CRAZE46,721,11/15/21
729,1,0,6,7,DAWG05,736,11/15/21
730,1,1,4,6,DAWG02,742,11/15/21
731,1,0,4,5,RECON73,733,11/15/21
732,1,0,6,7,DAWG04,748,11/15/21
733,0,2,4,6,DRAGN72,803,11/15/21
734,2,2,4,8,CRAZE34,727,11/15/21
735,3,2,4,9,BALL49,745,11/15/21
736,2,2,4,8,ETCH41,751,11/15/21
737,2,2,5,9,ETCH42,754,11/15/21
738,3,2,4,9,BALL49,745,11/15/21
739,0,2,4,6,CRAZE44,809,11/15/21
740,0,2,7,9,DRAGN03,806,11/15/21
741,2,1,4,7,SMALL54,800,11/15/21
742,4,0,7,11,DRAGN71,757,11/15/21
743,1,2,3,6,SCARE75,815,11/15/21
744,1,0,3,4,SHINR81,818,11/15/21
745,1,0,4,5,SHINR82,821,11/15/21
746,2,0,2,4,SMALL60,812,11/15/21
747,1,0,7,8,CRAZE25,824,11/15/21
748,0,1,6,7,BADGR09,833,11/15/21
749,2,0,4,6,COBRA01,827,11/15/21
750,0,1,1,2,BADGR05,839,11/15/21
751,0,1,6,7,BADGR08,830,11/15/21
752,0,3,3,6,PAWS54,836,11/15/21
753,0,1,2,3,BADGR02,842,11/15/21
754,1,1,7,9,AXLE11,845,11/15/21
755,1,1,2,4,AXLE12,848,11/15/21
756,2,0,4,6,RECON89,851,11/15/21
757,1,0,0,1,WIRE31,909,11/15/21
758,3,0,2,5,WIRE32,906,11/15/21
759,2,4,2,8,RECON08,854,11/15/21
760,2,2,3,7,RECON01,857,11/15/21
761,1,3,2,6,LOADED1,900,11/15/21
762,1,3,4,8,LOADED2,903,11/15/21
763,2,2,3,7,SLOW81,912,11/15/21
764,1,2,7,10,SLOW82,915,11/15/21
765,0,0,0,0,CRAZE22,933,11/15/21
766,0,0,4,4,DRAGN05,918,11/15/21
767,1,5,4,10,LOST11,924,11/15/21
768,1,5,4,10,LOST12,927,11/15/21
769,1,3,4,8,FILL11,936,11/15/21
770,1,3,1,5,FILL12,939,11/15/21
771,3,2,4,9,HOOK65,921,11/15/21
772,0,0,3,3,RENO71,930,11/15/21
773,0,0,0,0,RENO72,1009,11/15/21
774,1,3,0,4,TAUNT11,948,11/15/21
775,1,2,0,3,TAUNT12,951,11/15/21
776,1,4,4,9,DRAGN51,1012,11/15/21
777,3,2,4,9,DRAGN02,1021,11/15/21
778,2,3,1,6,TORA11,954,11/15/21
779,2,3,1,6,TORA12,957,11/15/21
780,0,2,3,5,COACH51,1015,11/15/21
781,0,2,2,4,COACH52,1018,11/15/21
782,2,3,1,6,HOODOO1,942,11/15/21
783,2,3,6,11,HOODOO2,945,11/15/21
784,2,3,4,9,DRAGN42,1024,11/15/21
785,1,2,1,4,DRAGN48,1027,11/15/21
786,0,4,2,6,PHANTM99,1030,11/15/21
787,1,3,2,6,TORA21,1033,11/15/21
788,1,3,1,5,TORA22,1036,11/15/21
789,4,4,2,10,GIZMO11,1039,11/15/21
790,4,4,2,10,GIZMO12,1042,11/15/21
791,0,2,4,6,BALL84,1045,11/15/21
792,1,3,10,14,HOOK25,1209,11/15/21
793,2,4,1,7,PAWS43,1051,11/15/21
794,1,3,5,9,Stab11,1054,11/15/21
795,1,3,4,8,Stab 12,1057,11/15/21
796,2,4,1,7,Epic 02,1048,11/15/21
797,2,1,7,10,Dragn 31,1100,11/15/21
798,0,2,8,10,Dragn 86,1115,11/15/21
799,1,4,6,11,Dragn 29,1109,11/15/21
800,2,4,4,10,Hang 51,1109,11/15/21
801,2,4,2,8,Hang 52,1112,11/15/21
802,1,1,0,2,Craze 79,1106,11/15/21
803,2,3,9,14,phntm 50,1118,11/15/21
804,1,3,1,5,Dragn 69,1151,11/15/21
805,2,2,5,9,DAWG 02,1142,11/15/21
806,1,1,5,7,DAWG 05,1136,11/15/21
807,0,2,7,9,DAWG 04,1145,11/15/21
808,1,3,7,11,WIRE 31,1130,11/15/21
809,1,3,10,14,WIRE 32,1133,11/15/21
810,1,4,2,7,HANG 51,1109,11/15/21
811,1,4,1,6,HANG 52,1112,11/15/21
812,1,2,2,5,VEGA 21,1124,11/15/21
813,1,2,3,6,VEGA 22,1127,11/15/21
814,0,4,5,9,CRAZE 34,1121,11/15/21
815,1,4,7,12,PHNTM 61,1139,11/15/21
816,1,4,4,9,DAWG 09,1148,11/15/21
817,0,3,7,10,HOOK 67,1154,11/15/21
818,2,3,3,8,DRAGN 66,1157,11/15/21
819,0,4,2,6,RECON 89,1300,11/15/21
820,2,4,1,7,BALL 69,1303,11/15/21
821,2,4,2,8,DRAGN 77,1309,11/15/21
822,1,3,8,12,SHINER 81,1312,11/15/21
823,1,3,4,8,SHINER 82,1315,11/15/21
824,2,3,1,6,COACH 21,1321,11/15/21
825,2,3,1,6,COACH 22,1324,11/15/21
826,2,3,7,12,DRAGN 03,1318,11/15/21
827,2,2,1,5,BALL 81,1306,11/15/21
828,2,3,4,9,BALL 18,1327,11/15/21
829,0,3,3,6,CRAZE 16,1333,11/15/21
830,2,2,5,9,BALL 11,1330,11/15/21
831,2,2,1,5,BALL 28,1336,11/15/21
832,2,2,3,7,BALL 25,1339,11/15/21
833,2,2,3,7,BALL 29,1342,11/15/21
834,3,2,2,7,SMALL 50,1348,11/15/21
835,0,2,2,4,BADGR 02,1345,11/15/21
836,1,3,2,6,DRAGN 16,1354,11/15/21
837,0,2,3,5,RECON 07,1351,11/15/21
838,0,2,3,5,DRAGN 52,1357,11/15/21
839,3,4,3,10,CRAZE 42,1400,11/15/21
840,2,2,1,5,DRAGN 51,1403,11/15/21
841,4,2,3,9,DRAGN 05,1409,11/15/21
842,4,2,2,8,PHNTM99,1406,11/15/21
843,0,3,1,4,BALL 03,1415,11/15/21
844,0,3,7,10,DRAGN 42,1412,11/15/21
845,1,3,3,7,AXEL 11,1418,11/15/21
846,1,3,3,7,AXEL 12,1421,11/15/21
847,1,2,0,3,WIRE 31,1430,11/15/21
848,3,2,0,5,WIRE 32,1433,11/15/21
849,0,3,4,7,PAWS 43,1436,11/15/21
850,2,0,1,3,CRAZE79,703,11/16/21
851,1,0,4,5,DRAGN66,700,11/16/21
852,1,0,4,5,AXLE11,706,11/16/21
853,1,0,2,3,AXLE12,706,11/16/21
854,1,2,7,10,VEGA11,712,11/16/21
855,1,2,7,10,VEAG12,712,11/16/21
856,2,2,5,9,COBRA05,721,11/16/21
857,1,2,7,10,DRAGN86,718,11/16/21
858,2,0,4,6,COBRA02,727,11/16/21
859,2,2,6,10,CRAZE34,724,11/16/21
860,2,0,5,7,BALL82,736,11/16/21
861,3,0,6,9,PHNTM50,730,11/16/21
862,1,2,5,8,CRAZE46,733,11/16/21
863,1,2,2,5,DAWG09,739,11/16/21
864,1,3,6,10,DAWG02,742,11/16/21
865,1,2,5,8,DAWG05,748,11/16/21
866,1,2,6,9,PHNTM61,745,11/16/21
867,1,0,5,6,DAWG04,751,11/16/21
868,1,2,2,5,DRAGN69,754,11/16/21
869,3,2,4,9,SCARE59,803,11/16/21
870,1,2,5,8,ETCH41,757,11/16/21
871,3,2,3,8,ETCH42,757,11/16/21
872,3,0,2,5,SMALL60,812,11/16/21
873,0,1,3,4,CRAZE44,815,11/16/21
874,2,2,5,9,DRAGN77,809,11/16/21
875,2,2,3,7,DRAGN73,809,11/16/21
876,3,3,1,7,SMALL67,833,11/16/21
877,1,2,3,6,DRAGN71,818,11/16/21
878,0,5,0,5,AMMO02,827,11/16/21
879,0,4,1,5,BALL11,830,11/16/21
880,1,3,3,7,SCARE76,830,11/16/21
881,1,2,4,7,SHINR81,821,11/16/21
882,1,2,1,4,SHINR82,824,11/16/21
883,0,3,3,6,BADGR05,839,11/16/21
884,0,2,3,5,BADGR08,836,11/16/21
885,0,2,4,6,BADGR09,842,11/16/21
886,0,3,4,7,RECON69,857,11/16/21
887,1,3,3,7,CRAZE54,848,11/16/21
888,0,5,2,7,BADGR02,851,11/16/21
889,0,2,3,5,RECON89,900,11/16/21
890,0,2,2,4,RECON07,854,11/16/21
891,3,3,1,7,RECON01,845,11/16/21
892,1,3,3,7,GIZMO21,906,11/16/21
893,1,3,3,7,GIZMO22,909,11/16/21
894,3,3,5,11,SLOW11,912,11/16/21
895,3,3,2,8,SLOW12,915,11/16/21
896,2,2,4,8,SLOW81,921,11/16/21
897,0,3,2,5,BALL02,903,11/16/21
898,1,2,7,10,SLOW82,921,11/16/21
899,3,2,2,7,SMALL15,927,11/16/21
900,3,3,5,11,HOOK01,924,11/16/21
901,1,2,3,6,LOADED01,930,11/16/21
902,1,2,2,5,LOADED02,933,11/16/21
903,1,4,1,6,FILL21,948,11/16/21
904,1,4,2,7,FILL22,951,11/16/21
905,1,3,1,5,SCARE09,1006,11/16/21
906,3,3,3,9,SLOW21,942,11/16/21
907,1,3,1,5,SLOW22,945,11/16/21
908,1,2,0,3,HOODOO01,936,11/16/21
909,1,2,1,4,HOODOO02,939,11/16/21
910,1,1,2,4,WIRE51,1009,11/16/21
911,1,1,3,5,WIRE52,1012,11/16/21
912,1,2,0,3,CRAZE42,1018,11/16/21
913,0,2,5,7,DRAGN42,1024,11/16/21
914,2,3,1,6,DRAGN61,1021,11/16/21
915,2,3,2,7,EVIL01,1015,11/16/21
916,2,3,2,7,SCARE15,1027,11/16/21
917,1,3,1,5,AXLE11,1033,11/16/21
918,3,3,1,7,AXLE12,1036,11/16/21
919,1,2,2,5,DRAGN44,1030,11/16/21
920,1,2,3,6,LOKR01,1039,11/16/21
921,1,2,1,4,LOKR02,1042,11/16/21
922,0,0,0,0,TORA81,0,11/16/21
923,0,0,0,0,TORA82,0,11/16/21
924,1,3,3,7,PHTNMN45,1045,11/16/21
925,0,2,6,8,DRAGN86,1109,11/16/21
926,0,3,3,6,BALL14,1057,11/16/21
927,1,3,0,4,VEGA21,1051,11/16/21
928,3,3,0,6,VEGA22,1054,11/16/21
929,0,3,5,8,Hook22,1118,11/16/21
930,1,2,5,8,PAWS11,1115,11/16/21
931,1,2,4,7,GHOST02,1124,11/16/21
932,1,3,5,9,CRAZE46,1124,11/16/21
933,0,3,5,8,HOOK24,1121,11/16/21
934,1,2,7,10,DAWG02,1136,11/16/21
935,1,2,4,7,DAWG05,1133,11/16/21
936,3,2,1,6,SMALL72,1142,11/16/21
937,1,3,5,9,HANG51,1145,11/16/21
938,1,3,5,9,HANG52,1145,11/16/21
939,1,2,5,8,DAWG04,1130,11/16/21
940,3,2,3,8,SMALL71,1139,11/16/21
941,4,3,3,10,CRAZE86,1151,11/16/21
942,2,2,5,9,ETCH41,1154,11/16/21
943,2,2,5,9,ETCH42,1154,11/16/21
944,2,3,5,10,DRAGON,1200,11/16/21
945,1,3,2,6,EAST86,1201,11/16/21
946,2,2,4,8,BALL69,1306,11/16/21
947,1,3,6,10,CREEP31,1312,11/16/21
948,1,3,6,10,CREEP32,1312,11/16/21
949,0,3,2,5,BALL08,1309,11/16/21
950,1,3,4,8,SHINR81,1318,11/16/21
951,1,3,4,8,SHINR82,1318,11/16/21
952,1,3,0,4,PAWS25,1324,11/16/21
953,1,3,6,10,COACH21,1330,11/16/21
954,2,3,0,5,BALL02,1327,11/16/21
955,0,2,3,5,BAGER02,1342,11/16/21
956,0,3,3,6,BADGER08,1339,11/16/21
957,3,3,0,6,SMALL51,1351,11/16/21
958,3,3,2,8,SMALL52,1354,11/16/21
959,1,3,2,6,AXLE11,1345,11/16/21
960,1,2,6,9,AXEL12,1345,11/16/21
961,1,2,2,5,DRAGN52,1357,11/16/21
962,1,3,6,10,HANG51,1409,11/16/21
963,1,1,4,6,WIRE31,1400,11/16/21
964,1,2,4,7,DRAGN22,1406,11/16/21
965,2,2,4,8,CRAZE28,1415,11/16/21
966,1,5,3,9,SCARE15,1421,11/16/21
967,2,4,1,7,PHNTM99,1418,11/16/21
968,1,3,1,5,STAB11,1427,11/16/21
969,3,3,2,8,STAB12,1427,11/16/21
970,1,3,0,4,VEGA21,1433,11/16/21
971,1,3,5,9,RECON84,1424,11/16/21
972,0,3,1,4,EPIC09,1439,11/16/21
973,2,2,6,10,CRAZE86,1442,11/16/21
974,2,2,3,7,DRAGN03,1527,11/16/21
975,2,5,2,9,BALL52,1727,11/16/21
976,2,3,3,8,EPIC01,1727,11/16/21
977,2,3,6,11,STAB11,700,11/17/21
978,0,5,4,9,DRAGN09,709,11/17/21
979,1,6,7,14,DRAGN24,712,11/17/21
980,2,2,8,12,COBRA08,721,11/17/21
981,0,3,4,7,HOOK22,715,11/17/21
982,2,5,6,13,COBRA22,718,11/17/21
983,3,3,3,9,DRAGN96,706,11/17/21
984,2,3,4,9,CRAZE46,724,11/17/21
985,2,4,4,10,BALL11,727,11/17/21
986,3,1,3,7,CRAZE88,733,11/17/21
987,1,4,3,8,DAWG09,736,11/17/21
988,1,2,4,7,DAWG05,739,11/17/21
989,1,3,2,6,DRAGN69,754,11/17/21
990,0,3,4,7,DAWG04,745,11/17/21
991,3,2,2,7,SMALL46,742,11/17/21
992,4,3,3,10,HOOK61,751,11/17/21
993,3,3,3,9,DRAGN66,748,11/17/21
994,1,1,4,6,RECON01,730,11/17/21
995,2,1,2,5,SMALL54,800,11/17/21
996,0,5,2,7,CRAZE44,757,11/17/21
997,2,5,8,15,HOOK71,806,11/17/21
998,0,3,3,6,CRAZE76,812,11/17/21
999,1,2,5,8,SCARE72,818,11/17/21
1000,0,3,2,5,CRAZE25,815,11/17/21
1001,3,5,6,14,DRAGN72,742,11/17/21
1002,3,5,6,14,HOOK01,745,11/17/21
1003,1,3,3,7,WIRE31,824,11/17/21
1004,0,4,2,6,CRAZE16,827,11/17/21
1005,0,6,3,9,PHNTM69,830,11/17/21
1006,0,5,4,9,BADGR01,833,11/17/21
1007,0,5,5,10,RECON07,836,11/17/21
1008,1,5,2,8,SCARE99,845,11/17/21
1009,1,6,3,10,CRAZE45,848,11/17/21
1010,2,3,2,7,DRAGN05,857,11/17/21
1011,0,6,0,6,BADGR08,839,11/17/21
1012,2,1,5,8,DRAGN31,900,11/17/21
1013,0,6,3,9,RECON08,851,11/17/21
1014,2,6,3,11,GIZMO31,921,11/17/21
1015,2,4,4,10,TAUNT21,906,11/17/21
1016,0,4,2,6,BALL69,854,11/17/21
1017,1,5,6,12,TORA31,915,11/17/21
1018,5,5,5,15,LOOT50,909,11/17/21
1019,5,3,5,13,BALL35,912,11/17/21
1020,1,6,8,15,LOOKER01,930,11/17/21
1021,0,5,3,8,HOOK44,933,11/17/21
1022,2,6,2,10,SLOW21,945,11/17/21
1023,3,3,1,7,SMALL37,1021,11/17/21
1024,1,6,4,11,VEGA51,1012,11/17/21
1025,5,5,2,12,HOOK48,1025,11/17/21
1026,1,6,1,8,PHNTM99,1024,11/17/21
1027,1,4,1,6,DRAGN59,1018,11/17/21
1028,1,6,5,12,DRAGN36,1024,11/17/21
1029,1,6,1,8,AXLE11,1032,11/17/21
1030,1,6,2,9,SCARE99,1030,11/17/21
1031,0,4,0,4,RECON03,1042,11/17/21
1032,2,5,1,8,TORA11,1006,11/17/21
1033,1,6,8,15,DRAGN19,1100,11/17/21
1034,2,6,1,9,SLOW51,1000,11/17/21
1035,1,6,0,7,VEGA21,1045,11/17/21
1036,1,6,11,18,STAB11,1054,11/17/21
1037,0,4,2,6,BALL62,1039,11/17/21
1038,2,3,0,5,CRAZE86,1103,11/17/21
1039,1,6,7,14,RENO11,1109,11/17/21
1040,1,6,0,7,HANG51,1115,11/17/21
1041,1,4,5,10,CRAZE46,1118,11/17/21
1042,2,4,1,7,COBRA01,1127,11/17/21
1043,1,4,10,15,COBRA08,1124,11/17/21
1044,1,4,7,12,DAWG02,1136,11/17/21
1045,1,4,6,11,CRAZE88,1130,11/17/21
1046,1,4,6,11,DAWG09,1132,11/17/21
1047,1,4,6,11,DAWG04,1139,11/17/21
1048,3,4,5,12,DAWG05,1142,11/17/21
1049,2,6,3,11,LOST11,1130,11/17/21
1050,1,6,6,13,CRAZE41,1127,11/17/21
1051,2,4,3,9,POST61,1148,11/17/21
1052,1,4,5,10,RENO71,1157,11/17/21
1053,2,4,7,13,DRAGN73,1318,11/17/21
1054,3,3,6,12,TORA81,1312,11/17/21
1055,2,5,8,15,DRAGN77,1324,11/17/21
1056,2,5,3,10,DRAGN71,1321,11/17/21
1057,2,4,2,8,WIRE31,1330,11/17/21
1058,0,6,3,9,BADGR02,1336,11/17/21
1059,0,4,4,8,BADGR01,1339,11/17/21
1060,2,4,8,14,SMALL41,1327,11/17/21
1061,0,5,0,5,BALL25,1345,11/17/21
1062,1,6,3,10,DRAGN51,1354,11/17/21
1063,0,10,6,16,RECON07,1342,11/17/21
1064,1,6,7,14,AXLE11,1348,11/17/21
1065,1,4,4,9,DRAGN04,1357,11/17/21
1066,0,6,6,12,DRAGN42,1406,11/17/21
1067,1,4,3,8,DRAGN46,1412,11/17/21
1068,1,5,0,6,PHNTM55,1400,11/17/21
1069,0,6,3,9,LOOT03,1409,11/17/21
1070,1,4,3,8,DRAGN17,1403,11/17/21
1071,0,6,4,10,SPECK69,1415,11/17/21
1072,2,3,2,7,CRAZE86,1433,11/17/21
1073,4,6,7,17,DRAGN86,1436,11/17/21
1074,0,6,2,8,BALL84,1418,11/17/21
1075,3,4,4,11,SMALL71,1439,11/17/21
1076,0,6,1,7,BALL99,1430,11/17/21
1077,0,6,0,6,GHOST53,1421,11/17/21
1078,0,6,4,10,BALL52,1424,11/17/21
1079,0,0,0,0,,0,11/17/21
1080,2,2,9,13,hang51,709,11/18/21
1081,2,2,4,8,hang51,712,11/18/21
1082,0,2,5,7,dragn83,706,11/18/21
1083,2,2,6,10,dragn86,715,11/18/21
1084,1,3,5,9,cobra05,718,11/18/21
1085,1,1,6,8,craze46,721,11/18/21
1086,1,3,6,10,ghost02,727,11/18/21
1087,1,3,6,10,phntm50,730,11/18/21
1088,2,3,6,11,dawg02,739,11/18/21
1089,1,3,4,8,crazy88,736,11/18/21
1090,2,3,7,12,dawg04,745,11/18/21
1091,0,3,4,7,hwk61,751,11/18/21
1092,2,3,6,11,cobra01,748,11/18/21
1093,1,2,7,10,etch41,757,11/18/21
1094,1,2,7,10,etch41,800,11/18/21
1095,2,3,1,6,ball49,742,11/18/21
1096,1,3,3,7,shinr81,806,11/18/21
1097,1,3,3,7,shinr82,809,11/18/21
1098,3,2,2,7,scare99,815,11/18/21
1099,0,3,2,5,hook71,806,11/18/21
1100,4,2,6,12,dragn66,754,11/18/21
1101,2,3,6,11,dragn03,812,11/18/21
1102,1,3,1,5,axle11,818,11/18/21
1103,1,3,1,5,axle12,821,11/18/21
1104,0,3,3,6,ammo02,827,11/18/21
1105,0,3,3,6,craze16,833,11/18/21
1106,0,3,2,5,craze54,836,11/18/21
1107,2,3,2,7,ball25,839,11/18/21
1108,0,3,2,5,badger02,842,11/18/21
1109,2,3,1,6,small75,851,11/18/21
1110,0,3,3,6,badgr01,854,11/18/21
1111,0,4,5,9,badgr09,848,11/18/21
1112,2,3,2,7,small77,857,11/18/21
1113,1,2,6,9,stab11,900,11/18/21
1114,1,2,8,11,stab11,903,11/18/21
1115,2,3,6,11,dawg05,845,11/18/21
1116,1,3,5,9,lost21,906,11/18/21
1117,1,3,3,7,lost21,909,11/18/21
1118,2,2,5,9,cobra08,912,11/18/21
1119,0,3,7,10,cobra02,915,11/18/21
1120,2,3,3,8,slow51,918,11/18/21
1121,1,3,8,12,slow52,921,11/18/21
1122,1,3,2,6,tora11,930,11/18/21
1123,1,3,6,10,tora11,933,11/18/21
1124,1,3,1,5,hook59,924,11/18/21
1125,1,3,1,5,hoodoo,936,11/18/21
1126,1,3,5,9,hoodoo,936,11/18/21
1127,1,3,0,4,tora21,942,11/18/21
1128,1,3,0,4,tora21,942,11/18/21
1129,3,3,1,7,small34,1012,11/18/21
1130,1,3,0,4,gizmo51,1006,11/18/21
1131,1,3,1,5,gizmo51,1009,11/18/21
1132,1,3,2,6,hang51,1018,11/18/21
1133,1,3,0,4,hang52,1021,11/18/21
1134,1,4,4,9,phntm51,1015,11/18/21
1135,0,2,3,5,DRAG48,1024,11/18/21
1136,1,3,1,5,POST 61,1032,11/18/21
1137,1,2,1,4,VEGA 21,1039,11/18/21
1138,1,2,1,4,PANTM55,1027,11/18/21
1139,1,2,3,6,DRAGN 44,1030,11/18/21
1140,5,1,2,8,CRAZE 79,1100,11/18/21
1141,1,2,1,4,COACH21,1045,11/18/21
1142,1,2,3,6,PAWS21,1003,11/18/21
1143,2,1,2,5,CRAZE86,1103,11/18/21
1144,1,4,4,9,SPOT11,1106,11/18/21
1145,1,4,2,7,SPOT11,1101,11/18/21
1146,2,2,5,9,DRAGN31,1057,11/18/21
1147,2,2,0,4,CRAZE33,1054,11/18/21
1148,4,2,8,14,DRAGN 86,1112,11/18/21
1149,3,2,5,10,SAMLL 61,1115,11/18/21
1150,0,2,0,2,RECON73,1051,11/18/21
1151,1,2,6,9,CRAZE48,1118,11/18/21
1152,1,2,5,8,CRAZE 46,1121,11/18/21
1153,1,2,8,11,GHOST02,1124,11/18/21
1154,1,2,5,8,PHNTM50,1130,11/18/21
1155,1,3,4,8,CRAZE 88,1133,11/18/21
1156,2,2,2,6,PAWG 02,1136,11/18/21
1157,0,2,3,5,DAWG 09,1139,11/18/21
1158,3,2,7,12,DAWG 04,1142,11/18/21
1159,1,2,3,6,DAWG 05,1145,11/18/21
1160,1,2,2,5,GIZMO21,1200,11/18/21
1161,2,4,7,13,HOOK 67,1154,11/18/21
1162,0,0,3,3,DRAGON 61,1148,11/18/21
1163,2,2,2,6,SMALL77,1157,11/18/21
1164,2,2,3,7,SAMLL75,1151,11/18/21
1165,1,2,8,11,WIRE31,1212,11/18/21
1166,3,2,6,11,WIRE32,1215,11/18/21
1167,1,2,5,8,BALL69,1300,11/18/21
1168,1,3,1,5,RENO71,1312,11/18/21
1169,1,3,8,12,RENO72,1315,11/18/21
1170,2,2,2,6,LODED1,1318,11/18/21
1171,2,2,1,5,LODED2,1321,11/18/21
1172,2,2,4,8,LODED3,1324,11/18/21
1173,2,2,2,6,LODED4,1327,11/18/21
1174,1,2,5,8,STAB11,1330,11/18/21
1175,1,2,5,8,STAB12,1333,11/18/21
1176,1,2,3,6,AXLE11,1336,11/18/21
1177,3,2,8,13,AXLE12,1339,11/18/21
1178,1,2,1,4,SHINER81,1348,11/18/21
1179,1,2,1,4,SHINER82,1348,11/18/21
1180,0,4,1,5,BADGR08,1400,11/18/21
1181,3,2,3,8,SMALL57,1409,11/18/21
1182,1,2,3,6,COACH21,1406,11/18/21
1183,1,2,2,5,COACH22,1409,11/18/21
1184,0,2,4,6,LOOT51,1415,11/18/21
1185,1,4,1,6,SPOT91,1354,11/18/21
1186,1,4,1,6,SPOT92,1357,11/18/21
1187,5,2,3,10,DRAGN52,1418,11/18/21
1188,2,2,3,7,SCARE17,1430,11/18/21
1189,1,2,3,6,DRAGN46,1433,11/18/21
1190,1,2,3,6,HANG51,1421,11/18/21
1191,1,2,1,4,HANG52,1424,11/18/21
1192,2,2,1,5,GIZMO11,1342,11/18/21
1193,2,2,2,6,GIZMO12,1345,11/18/21
1194,0,2,6,8,DRAGN42,1427,11/18/21
1195,0,4,3,7,Ball02,1436,11/18/21
1196,2,2,1,5,SMALL 79,1451,11/18/21
1197,1,2,0,3,WIRE 31,1448,11/18/21
1198,3,2,2,7,WIRE 32,1451,11/18/21
1199,2,2,4,8,CRAZE 86,1454,11/18/21
1200,1,2,3,6,POST61,1409,11/18/21
1201,3,2,2,7,POST 62,1439,11/18/21
1202,2,2,2,6,SMALL 15,1527,11/18/21
1203,1,2,6,9,DRAGN32,700,11/19/21
1204,3,2,4,9,SCARE 15,718,11/19/21
1205,0,2,6,8,DRAGON 22,715,11/19/21
1206,1,3,7,11,ETCH 41,724,11/19/21
1207,0,2,4,6,DRAGON 86,712,11/19/21
1208,1,3,4,8,ETCH 42,724,11/19/21
1209,2,3,7,12,HOOK 61,721,11/19/21
1210,1,3,4,8,CRAZE 86,730,11/19/21
1211,1,4,10,15,DRAGON 39,703,11/19/21
1212,0,1,8,9,DRAGON 71,736,11/19/21
1213,3,3,6,12,DRAGON 75,733,11/19/21
1214,0,2,11,13,DRAGON 72,742,11/19/21
1215,1,1,5,7,DRAGON 77,739,11/19/21
1216,1,2,7,10,LOOKER 01,745,11/19/21
1217,1,2,3,6,LOOKER 02,745,11/19/21
1218,1,4,7,12,DRAGON 52,751,11/19/21
1219,2,3,5,10,DRAGON 67,754,11/19/21
1220,3,3,4,10,DRAGON 44,809,11/19/21
1221,1,2,5,8,CRAZE 44,757,11/19/21
1222,0,3,7,10,DRAGON 42,806,11/19/21
1223,0,3,2,5,DRAGON 59,800,11/19/21
1224,1,1,2,4,RECON 05,824,11/19/21
1225,1,3,6,10,COBRA 08,803,11/19/21
1226,1,3,3,7,COBRA 05,827,11/19/21
1227,1,2,4,7,CRAZE 34,800,11/19/21
1228,1,4,5,10,LOOT 50,818,11/19/21
1229,2,1,2,5,SMALL 70,836,11/19/21
1230,0,3,2,5,RHINO 99,800,11/19/21
1231,4,1,2,7,SMALL 67,833,11/19/21
1232,4,1,2,7,SMALL 66,830,11/19/21
1233,2,2,1,5,SMALL 71,839,11/19/21
1234,3,1,1,5,SMALL 73,845,11/19/21
1235,3,3,2,8,RECON 01,821,11/19/21
1236,2,1,2,5,AXLE 11,845,11/19/21
1237,1,1,1,3,AXLE 12,845,11/19/21
1238,0,1,2,3,CRAZE 76,851,11/19/21
1239,2,1,0,3,BALL 18,824,11/19/21
1240,2,1,0,3,SMALL 77,857,11/19/21
1241,2,3,1,6,HOOK 83,900,11/19/21
1242,1,1,0,2,DRAGON 99,906,11/19/21
1243,1,4,3,8,LOADED 01,915,11/19/21
1244,1,4,1,6,LOADED 02,915,11/19/21
1245,2,4,5,11,SLOW 81,921,11/19/21
1246,2,4,4,10,SLOW 82,921,11/19/21
1247,1,1,3,5,SCARE 77,942,11/19/21
1248,1,1,3,5,SCARE 71,939,11/19/21
1249,1,3,6,10,LOST 11,909,11/19/21
1250,1,3,1,5,LOST 12,909,11/19/21
1251,1,1,3,5,SCARE 99,945,11/19/21
1252,4,4,3,11,TORA 11,927,11/19/21
1253,4,4,3,11,TORA 12,927,11/19/21
1254,1,4,1,6,TAUNT 81,933,11/19/21
1255,1,4,1,6,TAUNT 82,933,11/19/21
1256,2,1,0,3,SMALL 33,1009,11/19/21
1257,2,1,0,3,SMALL 32,1006,11/19/21
1258,0,3,0,3,BADGR 05,1003,11/19/21
1259,1,4,1,6,POST61,1018,11/19/21
1260,1,4,0,5,POST62,1021,11/19/21
1261,1,4,3,8,GOLEM11,1024,11/19/21
1262,1,4,3,8,GOLEM12,1027,11/19/21
1263,2,3,0,5,SMALL42,1030,11/19/21
1264,2,3,0,5,SMALL43,1033,11/19/21
1265,2,1,1,4,EPIC01,1221,11/19/21
1266,1,2,4,7,DRAGN17,1054,11/19/21
1267,1,1,6,8,DRAGN62,1103,11/19/21
1268,3,3,1,7,SMALL56,1106,11/19/21
1269,2,2,3,7,SMALL53,1057,11/19/21
1270,1,0,3,4,DRAGN67,1109,11/19/21
1271,3,0,4,7,SMALL61,1115,11/19/21
1272,2,1,5,8,SMALL60,1112,11/19/21
1273,3,1,8,12,SLOW11,1121,11/19/21
1274,1,1,4,6,SLOW12,1124,11/19/21
1275,0,3,6,9,DRAGN72,1100,11/19/21
1276,2,2,2,6,SMALL62,1118,11/19/21
1277,2,3,7,12,SMALL51,1115,11/19/21
1278,2,2,9,13,DRAGN71,1136,11/19/21
1279,2,1,3,6,SMALL65,1127,11/19/21
1280,0,4,2,6,DRAGN52,1130,11/19/21
1281,0,3,2,5,CRAZE78,1145,11/19/21
1282,1,3,2,6,GIZMO21,1139,11/19/21
1283,3,3,3,9,GIZMO22,1141,11/19/21
1284,0,1,2,3,BALL31,1151,11/19/21
1285,1,1,7,9,BALL38,1154,11/19/21
1286,1,1,2,4,GHOST02,1200,11/19/21
1287,1,2,2,5,CRAZE34,1157,11/19/21
1288,1,3,3,7,CRAZE34,1157,11/19/21
1289,0,2,3,5,DRAGN44,1239,11/19/21
1290,0,1,5,6,DRAGN42,1148,11/19/21
1291,0,3,3,6,DRAGN77,1245,11/19/21
1292,1,1,0,2,TORA31,1203,11/19/21
1293,1,1,2,4,TORA32,1206,11/19/21
1294,2,4,0,6,LOOKER1,1321,11/19/21
1295,2,4,2,8,LOOKER2,1324,11/19/21
1296,0,1,1,2,RECON01,1351,11/19/21
1297,0,1,1,2,CRAZE16,1348,11/19/21
1298,0,1,3,4,BADGR01,1357,11/19/21
1299,2,3,1,6,BALL18,1334,11/19/21
1300,2,0,1,3,BALL15,1342,11/19/21
1301,0,1,1,2,RAGTAG6,1318,11/19/21
1302,2,3,1,6,SMALL47,1345,11/19/21
1303,0,1,2,3,BADGER02,1354,11/19/21
1304,2,3,0,5,RAGTAG1,1303,11/19/21
1305,2,3,1,6,RAGTAG2,1306,11/19/21
1306,2,3,0,5,RAGTAG3,1309,11/19/21
1307,2,3,0,5,RAGTAG4,1312,11/19/21
1308,4,3,1,8,BALL27,1400,11/19/21
1309,0,3,0,3,RAGTAG5,1315,11/19/21
1310,2,3,3,8,GIZMO11,1412,11/19/21
1311,2,3,1,6,GIZMO12,1415,11/19/21
1312,1,0,3,4,DRAGN91,1403,11/19/21
1313,2,3,1,6,SMALL62,1418,11/19/21
1314,2,5,2,9,TAUNT21,1430,11/19/21
1315,2,5,2,9,TAUNT22,1433,11/19/21
1316,1,3,2,6,VEGA21,1421,11/19/21
1317,3,3,0,6,VEGA22,1424,11/19/21
1318,1,3,5,9,PAWS88,1333,11/19/21
1319,0,3,5,8,SPECK53,1427,11/19/21
1320,0,2,2,4,PAWS69,1409,11/19/21
1321,1,2,3,6,PAWS48,1436,11/19/21
1322,1,2,2,5,STAB11,1439,11/19/21
1323,1,2,3,6,STAB12,1442,11/19/21
1324,4,1,2,7,PAWS77,1242,11/19/21
1325,1,5,0,6,FILL21,1503,11/19/21
1326,1,5,0,6,FILL22,1506,11/19/21
1327,2,3,0,5,GIZMO31,1448,11/19/21
1328,0,3,2,5,HOOK29,1454,11/19/21
1329,0,0,2,2,GIZMO32,1600,11/19/21
1330,2,3,2,7,LOADED1,1621,11/19/21
1331,2,3,6,11,LOADED2,1624,11/19/21
1332,2,3,6,11,LOADED3,1627,11/19/21
1333,2,3,2,7,LOADED4,1630,11/19/21
1334,0,2,3,5,DRAGN77,736,11/22/21
1335,1,3,5,9,SHINR81,730,11/22/21
1336,1,3,3,7,SHINR81,733,11/22/21
1337,3,3,7,13,DRAGN62,739,11/22/21
1338,1,3,2,6,DRAGN69,742,11/22/21
1339,5,2,6,13,DRAGN01,745,11/22/21
1340,0,3,6,9,BADGR01,748,11/22/21
1341,0,3,2,5,BADGR08,800,11/22/21
1342,0,1,4,5,CRAZE54,751,11/22/21
1343,0,3,5,8,RECON07,757,11/22/21
1344,1,1,2,4,CRAZE16,754,11/22/21
1345,1,2,3,6,AXLE11,806,11/22/21
1346,1,2,3,6,AXLE12,806,11/22/21
1347,0,1,2,3,BALL81,818,11/22/21
1348,1,1,3,5,COACH21,817,11/22/21
1349,1,1,3,5,COACH22,817,11/22/21
1350,1,1,2,4,STAB11,821,11/22/21
1351,1,1,1,3,STAB12,824,11/22/21
1352,3,3,3,9,DRAGN17,833,11/22/21
1353,1,2,4,7,DRAGN04,827,11/22/21
1354,1,4,5,10,DRAGN52,830,11/22/21
1355,1,1,3,5,DRAGN48,842,11/22/21
1356,1,3,4,8,DRAGN42,833,11/22/21
1357,1,1,3,5,CRAZE21,845,11/22/21
1358,0,3,4,7,BALL14,848,11/22/21
1359,0,4,6,10,PHNTM51,836,11/22/21
1360,2,2,3,7,SLOW11,900,11/22/21
1361,1,2,8,11,SLOW12,903,11/22/21
1362,2,2,2,6,TUANT81,915,11/22/21
1363,1,2,0,3,TAUNT82,918,11/22/21
1364,2,3,2,7,SLOW21,906,11/22/21
1365,1,3,10,14,SLOW22,906,11/22/21
1366,1,5,5,11,DRAGN33,912,11/22/21
1367,0,1,2,3,DRAGN05,851,11/22/21
1368,1,3,5,9,LOST11,906,11/22/21
1369,1,3,3,7,LOST12,909,11/22/21
1370,1,2,1,4,TORA81,921,11/22/21
1371,1,2,1,4,TORA82,921,11/22/21
1372,1,3,1,5,TORA51,933,11/22/21
1373,1,3,1,5,TORA52,936,11/22/21
1374,1,3,5,9,BALL32,951,11/22/21
1375,1,6,4,11,WIRE51,957,11/22/21
1376,1,6,1,8,WIRE52,1000,11/22/21
1377,2,3,1,6,LOOKER1,927,11/22/21
1378,2,3,5,10,LOOKER2,930,11/22/21
1379,0,0,0,0,DRAGN41,954,11/22/21
1380,2,2,3,7,HOOK22,939,11/22/21
1381,1,3,0,4,VEGA21,1030,11/22/21
1382,1,3,1,5,VEGA22,1033,11/22/21
1383,2,4,1,7,DUKE16,1030,11/22/21
1384,2,3,1,6,SMALL45,1039,11/22/21
1385,2,2,2,6,AXLE11,1042,11/22/21
1386,2,2,2,6,AXLE12,1045,11/22/21
1387,0,5,3,8,DRAGN24,1036,11/22/21
1388,2,2,2,6,CREEP31,1042,11/22/21
1389,2,2,2,6,CREEP32,1045,11/22/21
1390,1,5,1,7,STAB11,1048,11/22/21
1391,1,5,3,9,STAB12,1051,11/22/21
1392,1,3,5,9,Dawg02,1100,11/22/21
1393,1,6,4,11,DRAGN32,1054,11/22/21
1394,1,2,2,5,GOLEM11,1057,11/22/21
1395,0,3,4,7,RECON09,1033,11/22/21
1396,1,6,2,9,COBRA05,1109,11/22/21
1397,1,3,1,5,CRAZE46,1106,11/22/21
1398,1,2,4,7,COBRA08,1112,11/22/21
1399,2,4,0,6,SMALL61,1115,11/22/21
1400,1,2,9,12,ETCH41,1127,11/22/21
1401,2,4,6,12,RECON03,1136,11/22/21
1402,1,4,2,7,SHINR81,1121,11/22/21
1403,3,4,4,11,SHINR82,1124,11/22/21
1404,1,2,3,6,ETCH41,1127,11/22/21
1405,1,2,7,10,ETCH42,1130,11/22/21
1406,2,1,6,9,DRAGN66,1121,11/22/21
1407,0,4,8,12,BADGR01,1139,11/22/21
1408,2,4,7,13,RECON07,1145,11/22/21
1409,0,2,0,2,BADGR02,1142,11/22/21
1410,1,2,0,3,BALL73,1212,11/22/21
1411,1,4,3,8,SCARE69,1148,11/22/21
1412,1,2,2,5,EASY86,1151,11/22/21
1413,1,2,5,8,WIRE31,1257,11/22/21
1414,1,2,2,5,WIRE32,1300,11/22/21
1415,1,0,1,2,COACH21,1336,11/22/21
1416,1,0,0,1,COACH22,1339,11/22/21
1417,3,4,4,11,EVIL01,1330,11/22/21
1418,0,3,5,8,LOOT03,1351,11/22/21
1419,0,4,6,10,PHNTM51,1342,11/22/21
1420,1,2,1,4,RENO71,1354,11/22/21
1421,1,2,5,8,RENO72,1339,11/22/21
1422,1,3,6,10,HOOK42,1351,11/22/21
1423,1,1,1,3,VEGA01,1406,11/22/21
1424,1,1,1,3,VEGA02,1409,11/22/21
1425,1,2,4,7,HANG51,1418,11/22/21
1426,1,2,2,5,HANG52,1421,11/22/21
1427,4,4,4,12,DRAGN24,1415,11/22/21
1428,2,2,3,7,DRAGN86,1412,11/22/21
1429,3,3,3,9,BALL14,1400,11/22/21
1430,1,2,0,3,PHNTM50,1433,11/22/21
1432,0,1,4,5,DRAGN31,1427,11/22/21
1433,1,1,1,3,CRAZE41,1448,11/22/21
1434,1,2,4,7,COBRA08,1445,11/22/21
1435,3,1,2,6,SMALL72,1442,11/22/21
1436,3,2,6,11,BALL41,1436,11/22/21
1437,0,5,3,8,CRAZE88,1424,11/22/21
1438,2,3,1,6,SMALL71,1439,11/22/21
1439,1,1,2,4,BALL31,1451,11/22/21
1440,3,1,1,5,STAB11,1427,11/22/21
1441,1,1,3,5,STAB11,1427,11/22/21
1442,1,2,6,9,HOOK33,1512,11/22/21
1443,2,2,4,8,DRAGN73,736,11/23/21
1444,0,2,7,9,DRAGN75,730,11/23/21
1445,0,0,2,2,HOOK71,733,11/23/21
1446,2,0,6,8,DRAGN66,739,11/23/21
1447,3,0,2,5,SMALL50,748,11/23/21
1448,2,2,7,11,AXLE11,742,11/23/21
1449,0,0,0,0,,0,11/23/21
1450,3,2,4,9,SCARE17,751,11/23/21
1451,0,4,3,7,BADGR05,754,11/23/21
1452,0,2,4,6,PAWS16,757,11/23/21
1453,1,4,7,12,SCARE07,800,11/23/21
1454,1,4,5,10,SCARE28,803,11/23/21
1455,1,0,3,4,WIRE31,812,11/23/21
1456,4,4,5,13,DRAGN51,824,11/23/21
1457,0,0,3,3,AMMO02,818,11/23/21
1458,0,3,4,7,DRAGN52,821,11/23/21
1459,0,3,3,6,BALL02,839,11/23/21
1460,0,3,4,7,EVIL01,827,11/23/21
1461,1,2,5,8,SCARE08,806,11/23/21
1462,1,0,6,7,DRAGN43,833,11/23/21
1463,2,0,2,4,PHNTM55,836,11/23/21
1464,1,2,4,7,SCARE29,830,11/23/21
1465,3,0,4,7,BALL81,842,11/23/21
1466,4,4,1,9,COACH21,851,11/23/21
1467,2,3,2,7,DRAGN22,857,11/23/21
1468,2,2,3,7,DRAGN24,903,11/23/21
1469,0,0,1,1,DRAGN83,900,11/23/21
1470,2,0,2,4,DRAGN38,906,11/23/21
1471,2,4,1,7,AMMO04,845,11/23/21
1472,4,0,2,6,HOOK44,915,11/23/21
1473,3,6,3,12,SLOW51,921,11/23/21
1474,2,3,6,11,DRAGN72,912,11/23/21
1475,5,3,5,13,HOOK42,918,11/23/21
1476,3,4,8,15,GIZMO11,932,11/23/21
1477,3,6,0,9,SLOW91,951,11/23/21
1478,3,8,3,14,LOST11,945,11/23/21
1479,3,6,3,12,TORA21,939,11/23/21
1480,4,6,5,15,TORA11,927,11/23/21
1481,4,4,2,10,SLOW21,957,11/23/21
1482,1,3,2,6,GHOST53,1006,11/23/21
1483,0,2,1,3,BALL88,1003,11/23/21
1484,0,0,7,7,DAWG01,1039,11/23/21
1485,0,2,3,5,STAB11,1033,11/23/21
1486,3,4,2,9,STAB12,1036,11/23/21
1487,1,0,2,3,DRAGN32,1030,11/23/21
1488,2,1,3,6,DAWG05,1042,11/23/21
1489,0,3,2,5,PHNTM51,1051,11/23/21
1490,2,2,1,5,DRAGN77,1103,11/23/21
1491,1,3,3,7,COBRA05,1054,11/23/21
1492,1,3,2,6,PAWS41,1048,11/23/21
1493,2,1,3,6,CRAZE88,1045,11/23/21
1494,1,5,4,10,SPOT91,1057,11/23/21
1495,1,5,2,8,SPOT92,1100,11/23/21
1496,3,0,1,4,CRAZE77,1115,11/23/21
1497,1,2,6,9,HOOK64,1112,11/23/21
1498,3,3,3,9,SHNR81,1106,11/23/21
1499,2,3,1,6,SHNR82,1109,11/23/21
1500,1,1,8,10,DRAGN67,1118,11/23/21
1501,1,3,7,11,DRAGN66,1121,11/23/21
1502,2,2,1,5,BALL27,1124,11/23/21
1503,0,3,7,10,RECON07,1136,11/23/21
1504,1,3,0,4,WIRE31,1127,11/23/21
1505,1,3,0,4,WIRE32,1130,11/23/21
1506,2,3,6,11,CRAZE16,1133,11/23/21
1507,1,3,1,5,COACH21,1139,11/23/21
1508,1,3,0,4,COACH22,1142,11/23/21
1509,3,2,3,8,VEGA51,1151,11/23/21
1510,3,2,2,7,VEGA52,1154,11/23/21
1511,1,3,2,6,HANG51,1145,11/23/21
1512,1,3,1,5,HANG52,1148,11/23/21
1513,5,3,0,8,SMALL77,1157,11/23/21
1514,3,3,2,8,CRAZE21,1200,11/23/21
1515,3,3,3,9,DRAGN48,1203,11/23/21
1516,0,2,2,4,PAWS55,1206,11/23/21
1517,1,1,2,4,EASY11,1209,11/23/21
1518,3,3,0,6,SMALL43,1333,11/23/21
1519,3,3,1,7,SMALL42,1330,11/23/21
1520,2,3,2,7,HOODO01,1336,11/23/21
1521,2,3,4,9,HOODO02,1339,11/23/21
1522,1,2,4,7,WIRE31,1330,11/23/21
1523,1,2,4,7,WIRE32,1333,11/23/21
1524,1,2,6,9,AXLE11,1348,11/23/21
1525,3,2,1,6,AXLE12,1351,11/23/21
1526,1,2,2,5,DRAGN09,1357,11/23/21
1527,1,3,0,4,STAB11,1400,11/23/21
1528,3,3,0,6,STAB12,1403,11/23/21
1529,3,3,1,7,SMALL62,1418,11/23/21
1530,2,3,1,6,SMALL61,1415,11/23/21
1531,0,3,2,5,DRAGN41,1403,11/23/21
1532,1,3,2,6,DAWG05,1409,11/23/21
1533,3,3,3,9,BALL44,1412,11/23/21
1534,4,3,2,9,DRAGN86,1427,11/23/21
1535,1,3,3,7,BADGR01,1421,11/23/21
1536,3,3,4,10,SMALL04,1500,11/23/21
1537,2,3,1,6,SMALL07,1509,11/23/21
1538,2,3,1,6,SMALL10,1512,11/23/21
1539,1,0,4,5,CRAZE 79,7000,11/24/21
1540,1,1,8,10,DRAGON 66,715,11/24/21
1541,3,3,4,10,SCARE 09,703,11/24/21
1542,1,1,4,6,DRAGON 73,706,11/24/21
1543,1,3,4,8,SCARE 36,715,11/24/21
1544,0,1,7,8,CRAZE 16,718,11/24/21
1545,0,1,3,4,BADGR 05,721,11/24/21
1546,1,1,2,4,POST 61,724,11/24/21
1547,1,0,4,5,RENO 71,730,11/24/21
1548,3,1,3,7,SMALL 50,748,11/24/21
1549,1,1,3,5,DRAGN 81,748,11/24/21
1550,3,3,6,12,DRAGN,803,11/24/21
1551,0,1,7,8,DRAGN 04,757,11/24/21
1552,1,1,6,8,DRAGN 41,806,11/24/21
1553,1,3,5,9,BALL 81,809,11/24/21
1554,3,1,6,10,CRAZE 21,800,11/24/21
1555,2,3,6,11,COBRA 01,742,11/24/21
1556,1,3,5,9,SHIN 81,836,11/24/21
1557,1,3,3,7,SHIN 82,839,11/24/21
1558,1,3,3,7,STAB 11,812,11/24/21
1559,1,1,2,4,RECON 88,812,11/24/21
1560,2,1,0,3,DRAGN 38,754,11/24/21
1561,1,3,5,9,SCARE 76,815,11/24/21
1562,2,3,1,6,GIZMO 11,827,11/24/21
1563,1,3,5,9,TAUNT 21,830,11/24/21
1564,2,3,6,11,SLOW 41,848,11/24/21
1565,3,1,4,8,RECON 02,857,11/24/21
1566,2,2,1,5,SLOW 21,909,11/24/21
1567,2,2,5,9,SLOW 22,912,11/24/21
1568,2,3,2,7,SLOW 11,842,11/24/21
1569,2,3,4,9,SLOW 22,845,11/24/21
1570,3,3,2,8,TORA 81,915,11/24/21
1571,3,3,0,6,CREEP 31,900,11/24/21
1572,2,5,2,9,DRAGN 83,921,11/24/21
1573,3,3,5,11,HOOK 33,857,11/24/21
1574,1,3,2,6,CRAZE 44,1018,11/24/21
1575,2,3,2,7,BALL 26,1003,11/24/21
1576,2,5,3,10,AXLE 11,1030,11/24/21
1577,0,3,0,3,CRAZE 43,1000,11/24/21
1578,2,3,2,7,DRAGN 86,1006,11/24/21
1579,2,5,4,11,WIRE31,1021,11/24/21
1580,2,5,4,11,WIRE32,1024,11/24/21
1581,3,6,4,13,DRAGN24,1015,11/24/21
1582,1,5,5,11,COBRA08,1030,11/24/21
1583,1,6,3,10,CRAZE46,1033,11/24/21
1584,2,3,1,6,AMMO01,1039,11/24/21
1585,1,5,4,10,DRAGN73,1045,11/24/21
1586,1,5,9,15,ETCH41,1048,11/24/21
1587,3,5,9,17,ETCH42,1051,11/24/21
1588,1,5,2,8,RECON71,1036,11/24/21
1589,1,5,2,8,RENO71,1057,11/24/21
1590,1,5,2,8,RENO72,1100,11/24/21
1591,2,5,4,11,RECON69,1109,11/24/21
1592,2,5,3,10,GHOST48,1027,11/24/21
1593,1,3,4,8,AXLE11,1103,11/24/21
1594,1,3,2,6,AXLE12,1106,11/24/21
1595,1,5,7,13,DRAGN66,1054,11/24/21
1596,0,5,1,6,LOOT69,1100,11/24/21
1597,4,3,2,9,DRAGN72,1042,11/24/21
1598,0,5,6,11,DRAGN51,1121,11/24/21
1599,1,5,8,14,DRAGN42,1139,11/24/21
1600,3,4,5,12,DRAGN41,1136,11/24/21
1601,1,6,2,9,SCARE99,1221,11/24/21
1602,0,2,1,3,RECON88,1303,11/24/21
1603,3,3,1,7,BALL35,1300,11/24/21
1604,2,3,4,9,BALL84,1309,11/24/21
1605,3,3,2,8,DRAGN02,1306,11/24/21
1606,2,3,4,9,DAWG01,1327,11/24/21
1607,4,3,0,7,DRAGN17,1342,11/24/21
1608,1,5,0,6,VEGA21,1330,11/24/21
1609,1,5,2,8,VEGA22,1333,11/24/21
1610,2,2,0,4,BALL44,1324,11/24/21
1611,4,5,3,12,DRAGN86,1336,11/24/21
1612,0,8,3,11,HOCK22,1339,11/24/21
1613,0,6,2,8,DAWG05,1357,11/24/21
1614,0,6,1,7,PHNTM61,1400,11/24/21
1615,3,4,0,7,SMALL60,1412,11/24/21
1616,3,3,2,8,SMALL55,1403,11/24/21
1617,1,4,5,10,STAB11,1351,11/24/21
1618,1,4,2,7,STAB12,1354,11/24/21
1619,1,5,4,10,DRAGN38,1348,11/24/21
1620,3,3,2,8,SMALL55,1403,11/24/21
1621,3,4,0,7,SMALL60,1412,11/24/21
1622,1,5,8,14,WIRE31,1406,11/24/21
1623,3,5,3,11,WIRE31,1406,11/24/21
1624,3,6,3,12,DRAGON01,1415,11/24/21
1625,0,4,4,8,DRAGN75,1439,11/24/21
1626,0,2,4,6,DRAGN48,1418,11/24/21
1627,1,2,3,6,dragn81,733,11/29/21
1628,2,2,7,11,ball04,742,11/29/21
1629,1,2,8,11,vega21,751,11/29/21
1630,1,2,5,8,vega22,754,11/29/21
1631,1,2,3,6,dawg09,800,11/29/21
1632,1,1,8,10,cobra02,809,11/29/21
1633,1,0,8,9,dawg01,757,11/29/21
1634,3,2,7,12,dawg04,803,11/29/21
1635,2,2,2,6,0806,806,11/29/21
1636,1,2,7,10,cobra08,815,11/29/21
1637,1,3,6,10,cobra05,818,11/29/21
1638,1,2,2,5,recon73,812,11/29/21
1639,1,2,3,6,PHNTM50,827,11/29/21
1640,0,0,5,5,dragn05,839,11/29/21
1641,2,2,3,7,craze40,830,11/29/21
1642,1,3,4,8,gizmo51,842,11/29/21
1643,1,3,4,8,gizmo52,845,11/29/21
1644,2,2,2,6,golem51,845,11/29/21
1645,2,2,2,6,golem52,848,11/29/21
1646,2,0,3,5,ball69,854,11/29/21
1647,3,0,1,4,ball88,857,11/29/21
1648,2,2,7,11,tora21,900,11/29/21
1649,2,2,2,6,tora22,903,11/29/21
1650,0,0,3,3,dragn43,836,11/29/21
1651,1,0,5,6,gizmo21,906,11/29/21
1652,1,0,2,3,gizmo22,909,11/29/21
1653,1,2,8,11,tora61,918,11/29/21
1654,1,2,6,9,tora62,921,11/29/21
1655,1,2,5,8,lost11,912,11/29/21
1656,1,2,3,6,lost12,915,11/29/21
1657,1,1,5,7,dragon91,833,11/29/21
1658,0,0,0,0,STAB11,0,11/29/21
1659,1,2,1,4,STAB11,1121,11/29/21
1660,1,2,1,4,STAB11,1121,11/29/21
1661,2,2,1,5,RENO11,1109,11/29/21
1662,4,2,2,8,DRGN25,933,11/29/21
1663,1,0,2,3,DRGN44,942,11/29/21
1664,0,0,1,1,BADGRO5,951,11/29/21
1665,0,0,4,4,BADGR01,948,11/29/21
1666,2,2,0,4,HOOK99,945,11/29/21
1667,1,0,1,2,COACH21,957,11/29/21
1668,1,0,1,2,COACH22,957,11/29/21
1669,0,2,0,2,BADGR09,954,11/29/21
1670,1,0,2,3,LOADED5,1003,11/29/21
1671,2,1,2,5,DRAGN77,1042,11/29/21
1672,1,2,2,5,DRAGN69,1054,11/29/21
1673,1,2,1,4,WIRE31,1030,11/29/21
1674,1,2,1,4,WIRE32,1030,11/29/21
1675,2,2,1,5,SMALL44,1036,11/29/21
1676,1,0,3,4,SCARE71,1039,11/29/21
1677,2,2,1,5,HOOK65,1057,11/29/21
1678,1,0,2,3,DRAGN07,1051,11/29/21
1679,1,2,2,5,PAWS45,1100,11/29/21
1680,1,2,2,5,SCARE12,1106,11/29/21
1681,1,2,1,4,DRAGN71,1045,11/29/21
1682,1,3,2,6,PHNTM03,1115,11/29/21
1683,0,2,5,7,HOOK41,1112,11/29/21
1684,1,2,1,4,PHNTM99,1118,11/29/21
1685,0,0,3,3,DRAGN32,1109,11/29/21
1686,0,2,2,4,DRAGN59,1154,11/29/21
1687,2,2,5,9,DRAGN52,1157,11/29/21
1688,0,3,0,3,HOOK51,1133,11/29/21
1689,1,2,1,4,EASY85,1215,11/29/21
1690,1,2,2,5,TORA11,1215,11/29/21
1691,1,2,1,4,TORA12,1218,11/29/21
1692,0,2,7,9,DAWG04,1232,11/29/21
1693,1,2,2,5,VEGA21,1227,11/29/21
1694,1,2,2,5,VEGA22,1230,11/29/21
1695,2,2,3,7,BALL05,1236,11/29/21
1696,3,2,3,8,SMALL23,1245,11/29/21
1697,2,2,2,6,TAUNT11,1121,11/29/21
1698,2,2,3,7,TAUNT12,1124,11/29/21
1699,0,2,7,9,DAWG01,1239,11/29/21
1700,1,2,4,7,COBRA01,1242,11/29/21
1701,3,2,3,8,BALL27,1148,11/29/21
1702,0,1,3,4,SPECK02,1251,11/29/21
1703,0,1,4,5,EPIC09,1254,11/29/21
1704,1,2,6,9,COBRA06,1257,11/29/21
1705,1,2,2,5,PAWS46,1300,11/29/21
1706,4,3,0,7,DRAGN17,1339,11/29/21
1707,1,2,7,10,RECON69,1330,11/29/21
1708,3,2,4,9,HANG51,1345,11/29/21
1709,3,2,1,6,HANG52,1348,11/29/21
1710,0,2,4,6,RECON88,1333,11/29/21
1711,2,2,2,6,DRAGN02,1336,11/29/21
1712,1,0,5,6,DRAGN43,1354,11/29/21
1713,1,2,3,6,DRAGN24,1342,11/29/21
1714,1,1,6,8,DRAGN32,1357,11/29/21
1715,0,2,1,3,CRAZE79,1351,11/29/21
1716,0,2,3,5,LOOT55,1400,11/29/21
1717,1,0,2,3,AXLE11,1403,11/29/21
1718,1,0,1,2,AXLE12,1406,11/29/21
1719,0,0,2,2,PAWS16,1412,11/29/21
1720,3,0,2,5,SMALL70,1436,11/29/21
1721,2,1,5,8,DRAGN44,1409,11/29/21
1722,4,2,1,7,DRAGN25,1503,11/29/21
1723,3,0,3,6,SMALL24,1548,11/29/21
1724,1,0,2,3,WIRE31,1527,11/29/21
1725,1,0,2,3,WIRE32,1530,11/29/21
1726,1,2,2,5,CRAZE44,1539,11/29/21
1727,1,0,3,4,CREEP31,1533,11/29/21
1728,1,0,1,2,CREEP32,1536,11/29/21
1729,2,2,6,10,DRAGN91,1545,11/29/21
1730,2,2,3,7,HOOK71,1542,11/29/21
1731,1,2,3,6,DRAGN66,1554,11/29/21
1732,0,0,3,3,CRAZE66,1551,11/29/21
1733,2,2,4,8,HOOK24,1718,11/29/21
1734,6,2,2,10,LOOT55,1736,11/29/21
1735,2,2,4,8,DRAGN 01,733,11/30/21
1736,1,2,4,7,DRAGN 81,739,11/30/21
1737,1,2,2,5,BALL 71,730,11/30/21
1738,0,2,2,4,DRAGN 52,736,11/30/21
1739,2,2,4,8,CRAZE 42,742,11/30/21
1740,1,2,4,7,VEGA 21,751,11/30/21
1741,1,2,3,6,VEGA 22,754,11/30/21
1742,1,2,7,10,AXLE 11,745,11/30/21
1743,1,2,1,4,AXLE 12,748,11/30/21
1744,2,0,2,4,SMALL 55,803,11/30/21
1745,2,2,8,12,DAWG 01,757,11/30/21
1746,0,3,4,7,DAWG 04,800,11/30/21
1747,1,3,7,11,COBRA 05,745,11/30/21
1748,1,3,5,9,COBRA 02,806,11/30/21
1749,0,0,3,3,Post 61,809,11/30/21
1750,0,0,3,3,Post 62,812,11/30/21
1751,3,2,3,8,SMALL 66,830,11/30/21
1752,0,2,5,7,HOOK 86,821,11/30/21
1753,0,2,5,7,CRAZE 69,824,11/30/21
1754,1,2,4,7,RECON 73,818,11/30/21
1755,0,2,7,9,DRAGN 22,827,11/30/21
1756,2,2,2,6,GOLEM 11,839,11/30/21
1757,2,2,2,6,GOLEM 12,841,11/30/21
1758,1,2,1,4,STAB 11,900,11/30/21
1759,1,2,2,5,STAB 12,903,11/30/21
1760,1,2,1,4,RENo 71,854,11/30/21
1761,1,2,0,3,RENO 72,857,11/30/21
1762,2,3,2,7,DRAGN 32,906,11/30/21
1763,1,2,5,8,TORA 11,848,11/30/21
1764,1,2,5,8,TORA 12,851,11/30/21
1765,0,2,3,5,HOOK 75,845,11/30/21
1766,1,0,4,5,CREEP 31,909,11/30/21
1767,1,0,4,5,CREEP 32,912,11/30/21
1768,0,0,2,2,BADGR 01,918,11/30/21
1769,0,2,0,2,CRAZE 54,915,11/30/21
1770,1,0,0,1,WIRE 31,930,11/30/21
1771,3,0,0,3,WIRE 32,933,11/30/21
1772,1,2,1,4,COACH 21,921,11/30/21
1773,2,2,2,6,COACH 22,924,11/30/21
1774,3,0,1,4,SHINR 81,936,11/30/21
1775,3,2,2,7,DRAGN 19,948,11/30/21
1776,2,2,2,6,CRAZE 28,945,11/30/21
1777,1,2,1,4,DRAGN 73,948,11/30/21
1778,1,0,1,2,DRAGN 61,951,11/30/21
1779,1,0,1,2,DRAGN 07,954,11/30/21
1780,1,0,2,3,DRAGN 66,957,11/30/21
1781,2,2,3,7,HANG 51,1000,11/30/21
1782,2,2,2,6,HANG 52,1000,11/30/21
1783,3,2,1,6,SCARE 99,1030,11/30/21
1784,1,1,4,6,PHNTM 03,1036,11/30/21
1785,1,2,1,4,SCARE 36,1106,11/30/21
1786,1,0,3,4,DRAGN 41,1042,11/30/21
1787,3,0,2,5,DRAGN 05,1045,11/30/21
1788,2,0,1,3,DRAGN 71,1039,11/30/21
1789,1,3,5,9,Dragon51,1103,11/30/21
1790,0,2,3,5,Craze42,0,11/30/21
1791,0,2,2,4,Drgn59,1112,11/30/21
1792,2,0,0,2,Post61,1115,11/30/21
1793,1,2,3,6,Gizmo11,1127,11/30/21
1794,3,2,1,6,Stab11,1154,11/30/21
1795,0,0,2,2,EVIL01,1200,11/30/21
1796,3,0,2,5,SMALL05,1203,11/30/21
1797,0,2,0,2,DAWG09,1203,11/30/21
1798,1,2,3,6,Looker1,1203,11/30/21
1799,0,1,5,6,RECON05,1224,11/30/21
1800,1,2,4,7,Recon77,1227,11/30/21
1801,2,2,1,5,LOADED1,1121,11/30/21
1802,1,3,2,6,GIZMO21,1215,11/30/21
1803,1,4,7,12,COBRA05,1236,11/30/21
1804,1,2,1,4,PHTM50,1233,11/30/21
1805,1,1,4,6,COBRA06,1234,11/30/21
1806,3,2,2,7,CRAZY11,1254,11/30/21
1807,1,2,3,6,RECON01,1230,11/30/21
1808,0,2,3,5,CRAZE46,1247,11/30/21
1809,2,2,0,4,SMALL23,1245,11/30/21
1810,2,2,4,8,DRGN86,1251,11/30/21
1811,0,0,7,7,CRAZE69,1248,11/30/21
1812,0,2,1,3,BALL81,1330,11/30/21
1813,1,2,0,3,REN71,1339,11/30/21
1814,1,2,2,5,REN72,1342,11/30/21
1815,1,0,3,4,VEGA21,1332,11/30/21
1816,1,2,1,4,DRGN44,1345,11/30/21
1817,1,0,1,2,DRGN02,1348,11/30/21
1818,0,0,1,1,BADGR05,1354,11/30/21
1819,2,2,3,7,BALL21,1351,11/30/21
1820,1,1,3,5,COACH21,1357,11/30/21
1821,1,1,2,4,COACH22,1400,11/30/21
1822,1,1,1,3,SHINR81,1403,11/30/21
1823,1,4,5,10,BALL89,1412,11/30/21
1824,0,4,5,9,HOOK75,1415,11/30/21
1825,2,2,1,5,SMALL77,1457,11/30/21
1826,1,6,0,7,DRGN03,1454,11/30/21
1827,1,1,3,5,DRGN66,1500,11/30/21
1828,2,2,6,10,ETCH41,1503,11/30/21
1829,2,3,3,8,ETCH42,1506,11/30/21
1830,2,4,2,8,HOOK 44,1736,11/30/21
1831,1,2,0,3,LOOT 55,1733,11/30/21
1832,1,0,3,4,BALL 89,1715,11/30/21
1833,2,4,4,10,HOOK 24,1739,11/30/21
1834,1,0,2,3,DRAGN 09,1742,11/30/21
1835,2,2,2,6,SMALL44,736,12/1/21
1836,3,2,3,8,SMALL42,730,12/1/21
1837,1,1,6,8,DRAGN52,733,12/1/21
1838,1,0,7,8,DAWG01,745,12/1/21
1839,2,2,5,9,GIZMO21,739,12/1/21
1840,2,2,4,8,GIZMO22,742,12/1/21
1841,0,2,3,5,DAWG,748,12/1/21
1842,1,2,5,8,CRAZE46,757,12/1/21
1843,2,0,3,5,PHTM61,754,12/1/21
1844,0,0,6,6,DAWG04,751,12/1/21
1845,0,3,6,9,COBRA02,800,12/1/21
1846,1,2,7,10,COBRA01,803,12/1/21
1847,1,2,6,9,COBRA08,806,12/1/21
1848,3,0,1,4,LOOT50,809,12/1/21
1849,1,3,5,9,COBRA05,815,12/1/21
1850,1,2,5,8,HANG51,818,12/1/21
1851,1,2,3,6,HANG52,821,12/1/21
1852,1,2,2,5,RECON73,812,12/1/21
1853,0,3,4,7,DRAGN22,824,12/1/21
1854,1,3,1,5,TORA51,836,12/1/21
1855,1,3,2,6,TORA52,839,12/1/21
1856,1,2,4,7,CRAZE09,851,12/1/21
1857,0,2,0,2,RECON88,857,12/1/21
1858,1,2,3,6,CREEP31,900,12/1/21
1859,1,2,5,8,CREEP32,903,12/1/21
1860,1,2,1,4,SCARE69,854,12/1/21
1861,1,1,5,7,PRAGN43,900,12/1/21
1862,1,2,1,4,TORA21,842,12/1/21
1863,1,2,1,4,TORA22,845,12/1/21
1864,1,3,1,5,LOST11,906,12/1/21
1865,1,3,3,7,LOST12,909,12/1/21
1866,1,2,3,6,POST61,912,12/1/21
1867,1,2,3,6,POST62,915,12/1/21
1868,2,2,2,6,DRAGN38,933,12/1/21
1869,1,2,2,5,STAB11,921,12/1/21
1870,1,2,1,4,STAB12,924,12/1/21
1871,2,1,1,4,BALL89,918,12/1/21
1872,2,2,1,5,AXLE11,945,12/1/21
1873,1,2,0,3,AXLE12,948,12/1/21
1874,1,2,2,5,RENO71,939,12/1/21
1875,3,2,0,5,RENO72,942,12/1/21
1876,3,3,4,10,DRAGN32,945,12/1/21
1877,2,2,2,6,DRAGN35,936,12/1/21
1878,1,2,3,6,SHINR81,954,12/1/21
1879,1,2,0,3,SHINR82,957,12/1/21
1880,1,2,1,4,COACH21,1000,12/1/21
1881,1,2,2,5,COACH22,1003,12/1/21
1882,0,2,4,6,DRAGN72,1030,12/1/21
1883,0,2,2,4,DRAGN59,1033,12/1/21
1884,0,2,7,9,DRAGN71,1036,12/1/21
1885,2,2,1,5,SMALL51,1051,12/1/21
1886,1,2,2,5,ETCH41,1103,12/1/21
1887,1,2,1,4,ETCH42,1106,12/1/21
1888,1,2,1,4,TORA41,1054,12/1/21
1889,1,2,1,4,TORA42,1057,12/1/21
1890,0,2,7,9,HOOK52,1100,12/1/21
1891,2,2,2,6,CRAZE28,1112,12/1/21
1892,1,2,0,3,EASY80,1101,12/1/21
1893,3,2,0,5,DRAGN41,1109,12/1/21
1894,1,2,2,5,SCARE99,1115,12/1/21
1895,3,2,3,8,DRAGN44,1118,12/1/21
1896,1,2,4,7,HANG51,1100,12/1/21
1897,1,2,4,7,HANG52,1100,12/1/21
1898,1,2,3,6,SPOT91,1124,12/1/21
1899,4,2,0,6,HOOK17,1200,12/1/21
1900,1,2,2,5,POST61,1148,12/1/21
1901,1,2,0,3,POST62,1148,12/1/21
1902,2,2,8,12,AXLE11,1227,12/1/21
1903,2,2,6,10,AXLE12,1227,12/1/21
1904,2,2,3,7,RENO71,1233,12/1/21
1905,2,2,0,4,RENO72,1233,12/1/21
1906,0,2,6,8,DAWG01,1242,12/1/21
1907,0,2,4,6,DAWG05,1239,12/1/21
1908,0,2,2,4,DAWG09,1245,12/1/21
1909,1,2,6,9,CRAZE46,1251,12/1/21
1910,0,2,6,8,COBRA02,1251,12/1/21
1911,0,2,7,9,COBRA01,1254,12/1/21
1912,1,2,6,9,COBRA05,1300,12/1/21
1913,1,2,6,9,COBRA06,1303,12/1/21
1914,4,2,8,14,BALL38,1257,12/1/21
1915,2,2,2,6,CRAZE79,1345,12/1/21
1916,0,2,3,5,BALL81,1330,12/1/21
1917,0,2,2,4,GHOST53,1333,12/1/21
1918,2,2,3,7,STAB11,1336,12/1/21
1919,2,2,4,8,STAB12,1339,12/1/21
1920,0,2,5,7,DRAGN32,1336,12/1/21
1921,0,2,3,5,CRAZE16,1348,12/1/21
1922,1,2,3,6,VEGA21,1400,12/1/21
1923,0,2,1,3,VEGA22,1403,12/1/21
1924,3,2,0,5,SMALL61,1415,12/1/21
1925,1,2,1,4,COACH21,1321,12/1/21
1926,1,2,3,6,COACH22,1321,12/1/21
1927,0,2,1,3,BADGR01,1357,12/1/21
1928,2,2,1,5,SMALL56,1406,12/1/21
1929,0,2,0,2,HOOK03,1412,12/1/21
1930,0,4,3,7,BADGR05,1409,12/1/21
1931,0,1,1,2,DRAGN05,1418,12/1/21
1932,1,2,2,5,AXLE11,1448,12/1/21
1933,1,2,4,7,AXLE12,1451,12/1/21
1934,3,2,5,10,DRAGN86,1454,12/1/21
1935,1,2,3,6,DRAGN66,1527,12/1/21
1936,0,0,0,0,HOOK62,1521,12/1/21
1937,1,2,0,3,ETCH41,1524,12/1/21
1938,1,2,0,3,ETCH42,1524,12/1/21
1939,1,2,1,4,DRAGN69,1524,12/1/21
1940,3,2,5,10,RENO 71,1530,12/1/21
1941,2,2,3,7,HOOK25,1718,12/1/21
1942,2,2,2,6,HOOK05,1727,12/1/21
1943,6,2,2,10,HOOK42,1724,12/1/21
1944,2,2,4,8,BALL64,1730,12/1/21
1945,0,2,6,8,DRAGN51,730,12/2/21
1946,0,3,4,7,DRAGN01,734,12/2/21
1947,1,2,4,7,DRAGN71,733,12/2/21
1948,4,2,3,9,CRAZE42,736,12/2/21
1949,3,2,6,11,POST61,742,12/2/21
1950,1,2,2,5,POST62,745,12/2/21
1951,0,2,0,2,DAWG02,803,12/2/21
1952,1,2,2,5,BALL05,800,12/2/21
1953,2,2,2,6,SMALL62,818,12/2/21
1954,1,0,6,7,COBRA08,809,12/2/21
1955,1,2,4,7,COBRA05,812,12/2/21
1956,1,0,2,3,SCARE69,838,12/2/21
1957,1,1,6,8,LOOKER01,757,12/2/21
1958,2,1,5,8,LOOKER02,800,12/2/21
1959,2,2,4,8,GIZMO21,830,12/2/21
1960,1,2,2,5,GIZMO22,833,12/2/21
1961,1,0,7,8,COBRA01,815,12/2/21
1962,4,2,8,14,TORA11,836,12/2/21
1963,4,2,3,9,TORA12,839,12/2/21
1964,1,2,5,8,GIZMO31,842,12/2/21
1965,1,2,2,5,GIZMO32,845,12/2/21
1966,1,2,3,6,CRAZE34,821,12/2/21
1967,2,2,1,5,SLOW11,824,12/2/21
1968,1,2,0,3,SLOW12,827,12/2/21
1969,1,2,3,6,STAB11,851,12/2/21
1970,1,2,3,6,STAB12,854,12/2/21
1971,0,2,3,5,DRAGN17,909,12/2/21
1972,1,0,2,3,ETCH41,857,12/2/21
1973,1,0,3,4,ETCH42,900,12/2/21
1974,2,2,2,6,DRAGN22,906,12/2/21
1975,3,2,2,7,DRAGN86,903,12/2/21
1976,0,2,3,5,HOOK75,912,12/2/21
1977,2,2,2,6,CRAZY11,918,12/2/21
1978,2,0,1,3,SMALL11,915,12/2/21
1979,2,0,1,3,EVIL02,921,12/2/21
1980,3,3,3,9,DRAGN39,927,12/2/21
1981,1,0,0,1,SCARE37,933,12/2/21
1982,1,0,3,4,DRAGN38,924,12/2/21
1983,1,2,2,5,VEGA21,942,12/2/21
1984,1,2,0,3,VEGA22,945,12/2/21
1985,1,2,0,3,COACH21,936,12/2/21
1986,1,2,0,3,COACH22,939,12/2/21
1987,0,2,2,4,PAWS16,948,12/2/21
1988,3,0,3,6,SHINR81,951,12/2/21
1989,1,0,1,2,SHINR82,954,12/2/21
1990,0,2,5,7,DRAGN72,1033,12/2/21
1991,1,0,1,2,CREEP31,957,12/2/21
1992,1,0,1,2,CREEP32,1000,12/2/21
1993,2,2,2,6,SMALL44,1036,12/2/21
1994,1,2,3,6,GIZMO11,1003,12/2/21
1995,1,2,0,3,GIZMO22,1006,12/2/21
1996,0,2,5,7,DRAGN03,1030,12/2/21
1997,1,0,3,4,DRAGN62,1045,12/2/21
1998,1,2,1,4,AXLE11,1039,12/2/21
1999,3,2,1,6,AXLE12,1042,12/2/21
2000,2,2,1,5,DRAGN07,1048,12/2/21
2001,2,0,3,5,DRAGN67,1051,12/2/21
2002,1,2,5,8,DRAGN52,1103,12/2/21
2003,2,2,2,6,HOOK81,1209,12/2/21
2004,2,2,2,6,CRAZE42,1106,12/2/21
2005,0,0,3,3,DRAGN44,1112,12/2/21
2006,4,0,2,6,STAB11,1154,12/2/21
2007,0,2,1,3,HOOK05,1118,12/2/21
2008,2,0,6,8,LOADED01/02,1115,12/2/21
2009,4,4,6,14,GIZMO11/12,1148,12/2/21
2010,2,2,5,9,BALL05,1215,12/2/21
2011,6,0,2,8,POST61/62,1206,12/2/21
2012,0,2,1,3,DAWG05,1218,12/2/21
2013,1,2,6,9,DAWG02,1245,12/2/21
2014,0,0,7,7,COBRA05,1224,12/2/21
2015,0,2,4,6,CRAZE46,1233,12/2/21
2016,1,1,8,10,COBRA08,1230,12/2/21
2017,2,0,7,9,HANG51/52,1245,12/2/21
2018,0,2,3,5,COBRA06,1227,12/2/21
2019,2,4,6,12,WIRE31/32,1239,12/2/21
2020,1,2,2,5,SCARE72,1257,12/2/21
2021,3,2,0,5,BALL77,1300,12/2/21
2022,0,2,5,7,CRAZE34,1236,12/2/21
2023,2,2,5,9,DRAGN38,1351,12/2/21
2024,2,0,3,5,CREEP31/32,1345,12/2/21
2025,1,2,2,5,HOOK69,1342,12/2/21
2026,0,0,2,2,BADGR05,1354,12/2/21
2027,3,0,6,9,COACH21/22,1400,12/2/21
2028,0,0,2,2,BADGR01,1359,12/2/21
2029,1,0,2,3,BALL27,1406,12/2/21
2030,0,2,0,2,LOOT06,1409,12/2/21
2031,4,0,3,7,SPOT91/92,1415,12/2/21
2032,0,0,3,3,RECON99,1412,12/2/21
2033,1,2,6,9,HOOK72,1448,12/2/21
2034,1,2,1,4,HOOK77,1451,12/2/21
2035,3,2,2,7,SMALL10,1512,12/2/21
2036,1,2,2,5,HOOK03,1454,12/2/21
2037,1,2,4,7,HOOK75,1509,12/2/21
2038,6,2,3,11,SLOW41,1518,12/2/21
2039,1,2,2,5,SLOW42,1521,12/2/21
2040,3,2,6,11,BALL01,1515,12/2/21
2041,0,0,0,0,CRAZY42,0,12/3/21
2042,0,3,3,6,CRAZY42,921,12/3/21
2043,0,2,4,6,DARGN52,918,12/3/21
2044,0,0,6,6,DRAGN44,930,12/3/21
2045,0,2,6,8,DRAGN51,924,12/3/21
2046,1,2,3,6,DRAGN38,927,12/3/21
2047,3,2,6,11,PHNTM99,936,12/3/21
2048,1,0,4,5,Wire31,1015,12/3/21
2049,1,0,3,4,WIRE32,1015,12/3/21
2050,1,2,5,8,HOOK24,824,12/3/21
2051,1,2,3,6,HANG51,812,12/3/21
2052,1,2,1,4,HANG52,815,12/3/21
2053,2,2,0,4,SHINR81,818,12/3/21
2054,2,2,4,8,SHINR82,0,12/3/21
2055,2,2,4,8,DAWG02,809,12/3/21
2056,0,2,6,8,DAWG04,800,12/3/21
2057,0,2,4,6,DAWG05,803,12/3/21
2058,2,3,2,7,TORA21,842,12/3/21
2059,2,3,3,8,TORA22,845,12/3/21
2060,2,2,2,6,SLOW11,854,12/3/21
2061,2,2,4,8,SLOW12,857,12/3/21
2062,0,3,1,4,RHINO99,0,12/3/21
2063,2,2,2,6,SLOW51,900,12/3/21
2064,1,2,0,3,SLOW52,903,12/3/21
2065,1,0,3,4,SCARE76,906,12/3/21
2066,0,2,3,5,BALL88,909,12/3/21
2067,1,2,0,3,RECON05,909,12/3/21
2068,1,0,2,3,CREEP31,921,12/3/21
2069,3,0,2,5,CREEP32,924,12/3/21
2070,2,2,3,7,DRAGN91,915,12/3/21
2071,1,0,1,2,RENO71,927,12/3/21
2072,1,0,3,4,RENO72,930,12/3/21
2073,0,2,2,4,DRAGN39,933,12/3/21
2074,1,2,1,4,CRAZE44,918,12/3/21
2075,1,1,1,3,STAB11,942,12/3/21
2076,1,1,1,3,STAB12,945,12/3/21
2077,4,4,2,10,BALL29,939,12/3/21
2078,1,0,2,3,FURY02,948,12/3/21
2079,1,0,1,2,ETCH41,954,12/3/21
2080,1,0,0,1,ETCH42,957,12/3/21
2081,2,2,1,5,SMALL45,1039,12/3/21
2082,0,0,4,4,CRAZY45,951,12/3/21
2083,0,2,0,2,LOOT06,933,12/3/21
2084,1,2,2,5,DRAGN77,1042,12/3/21
2085,1,0,0,1,RECON99,1036,12/3/21
2086,0,3,1,4,HOOK61,1057,12/3/21
2087,1,0,0,1,AXLE11,1051,12/3/21
2088,1,0,0,1,AXLE12,1054,12/3/21
2089,2,0,3,5,SMALL62,1118,12/3/21
2090,0,3,2,5,CRAZE42,1121,12/3/21
2091,4,1,3,8,CRAZY69,1100,12/3/21
2092,3,0,3,6,SMALL66,1130,12/3/21
2093,3,0,4,7,SMALL65,1127,12/3/21
2094,3,0,3,6,SMALL64,1124,12/3/21
2095,0,2,4,6,DRAGN52,1112,12/3/21
2096,3,2,4,9,DRAGN38,1209,12/3/21
2097,4,2,3,9,LOST11,0,12/3/21
2098,2,0,0,2,SMALL25,1251,12/3/21
2099,2,0,2,4,SMALL21,1239,12/3/21
2100,2,0,1,3,SMALL26,1254,12/3/21
2101,2,0,1,3,SMALL24,1248,12/3/21
2102,4,2,2,8,LOST12,0,12/3/21
2103,2,0,2,4,DRAGN36,1233,12/3/21
2104,1,0,3,4,SCARE73,1230,12/3/21
2105,0,0,3,3,DAWG01,1224,12/3/21
2106,1,2,5,8,DAWG02,0,12/3/21
2107,0,2,5,7,DAWG05,1227,12/3/21
2108,2,0,7,9,DAWG04,1239,12/3/21
2109,0,0,2,2,BALL35,1257,12/3/21
2110,2,0,2,4,HOOK81,1300,12/3/21
2111,2,2,3,7,TORA11,0,12/3/21
2112,2,0,1,3,SMALL45,1339,12/3/21
2113,1,0,4,5,POST61,1333,12/3/21
2114,1,0,6,7,POST61,1342,12/3/21
2115,0,4,4,8,HOOK67,1330,12/3/21
2116,0,2,3,5,SCARE75,1345,12/3/21
2117,0,2,2,4,BALL02,1354,12/3/21
2118,1,0,3,4,VEGA21,1348,12/3/21
2119,1,0,3,4,VEGA22,1351,12/3/21
2120,2,3,4,9,WIRE31,1357,12/3/21
2121,2,3,4,9,WIRE32,1400,12/3/21
2122,3,0,0,3,SMALL56,1406,12/3/21
2123,2,0,1,3,SMALL60,1412,12/3/21
2124,1,0,6,7,TORA31,1415,12/3/21
2125,1,0,3,4,TORA32,1418,12/3/21
2126,1,0,3,4,STAB11,1424,12/3/21
2127,3,0,2,5,STAB12,1427,12/3/21
2128,2,0,3,5,GOLEM11,1430,12/3/21
2129,2,0,2,4,GOLEM12,1433,12/3/21
2130,2,2,0,4,SMALL06,1506,12/3/21
2131,3,0,0,3,SMALL10,1512,12/3/21
2132,2,3,4,9,HOOK86,1521,12/3/21
2133,0,2,3,5,HOOK05,1542,12/3/21
2134,0,2,4,6,hook75,1421,12/3/21
2135,1,2,1,4,BALL89,1530,12/3/21
2136,1,1,1,3,BALL11,1530,12/3/21
2137,0,0,0,0,HOOK03,1551,12/3/21
2138,3,2,1,6,HOOK66,1548,12/3/21
2139,5,4,3,12,HOOK42,1536,12/3/21
2140,3,3,3,9,HOOK22,1557,12/3/21
2141,3,0,2,5,DRAGN61,1633,12/3/21
2142,3,0,2,5,HOOK41,1539,12/3/21
2143,0,2,1,3,PANS88,1409,12/3/21
2144,1,2,0,3,HOOK17,1515,12/3/21
2145,5,2,1,8,BALL12,1530,12/3/21
2146,0,5,7,12,DAWG 01,824,12/6/21
2147,1,4,6,11,DRAGN 31,818,12/6/21
2148,0,3,2,5,PHNTM50,821,12/6/21
2149,0,2,4,6,COBRA08,839,12/6/21
2150,2,2,1,5,DRAGN35,815,12/6/21
2151,1,4,6,11,DRAGN31,818,12/6/21
2152,3,2,1,6,SMACC72,842,12/6/21
2153,0,1,3,4,AMMO 02,800,12/6/21
2154,0,3,4,7,DAWG05,830,12/6/21
2155,1,4,4,9,BALL32,836,12/6/21
2156,0,3,3,6,CRAZE46,845,12/6/21
2157,0,6,5,11,DAWG04,827,12/6/21
2158,0,5,5,10,GHOST48,832,12/6/21
2159,2,2,2,6,DRAGN99,812,12/6/21
2160,0,3,4,7,HOOK21,806,12/6/21
2161,3,2,5,10,DRAGN24,803,12/6/21
2162,0,3,0,3,DRAGN36,809,12/6/21
2163,0,2,5,7,COBRA05,848,12/6/21
2164,1,1,3,5,CREEP31,854,12/6/21
2165,2,1,0,3,BALL75,900,12/6/21
2166,1,2,0,3,VEGA21/22,903,12/6/21
2167,1,4,4,9,COACH21/22,915,12/6/21
2168,0,3,1,4,Ball15,912,12/6/21
2169,1,4,0,5,Ball 69,921,12/6/21
2170,1,3,6,10,DRAGN91,933,12/6/21
2171,1,3,0,4,Ball29,936,12/6/21
2172,0,4,2,6,BALL08,924,12/6/21
2173,1,4,1,6,TAUNT11,951,12/6/21
2174,1,4,4,9,TAUNT12,951,12/6/21
2175,4,2,5,11,STAB11,1009,12/6/21
2176,4,2,4,10,STAB12,1012,12/6/21
2177,1,4,1,6,FILL21,939,12/6/21
2178,1,4,1,6,FILL22,942,12/6/21
2179,1,2,1,4,GOLEM21,945,12/6/21
2180,1,4,1,6,GOLEM22,948,12/6/21
2181,1,2,2,5,TORA21,1003,12/6/21
2182,1,2,5,8,TORA22,1006,12/6/21
2183,1,2,2,5,GIZMO11,957,12/6/21
2184,1,4,2,7,GIZMO12,1000,12/6/21
2185,0,5,2,7,DRAGN51,1018,12/6/21
2186,0,4,5,9,HOOK72,1000,12/6/21
2187,0,6,2,8,HOOK03,1030,12/6/21
2188,1,3,0,4,TORA61,1024,12/6/21
2189,0,6,1,7,HOOK41,1012,12/6/21
2190,0,5,3,8,HOOK44,1018,12/6/21
2191,0,4,3,7,Dragn75,1103,12/6/21
2192,2,3,1,6,DRAGN66,1115,12/6/21
2193,3,4,1,8,DRGN02,1106,12/6/21
2194,0,2,6,8,DRAGN04,1112,12/6/21
2195,1,5,0,6,EASY42,1116,12/6/21
2196,0,4,1,5,BALL14,1127,12/6/21
2197,1,6,2,9,FURY01,1124,12/6/21
2198,1,6,2,9,AXLE11,1130,12/6/21
2199,0,3,4,7,HOOK21,1139,12/6/21
2200,1,3,3,7,EPIC02,1121,12/6/21
2201,0,7,0,7,PHNTM55,1136,12/6/21
2202,0,4,4,8,DRAGN86,1145,12/6/21
2203,4,5,6,15,DRAGN25,1142,12/6/21
2204,2,5,7,14,DRAGN32,1151,12/6/21
2205,2,5,5,12,DRAGN31,1148,12/6/21
2206,1,5,1,7,SCARE76,1154,12/6/21
2207,1,4,7,12,COBRA02,1212,12/6/21
2208,0,3,5,8,DAWG01,1200,12/6/21
2209,0,5,3,8,PHNTM61,1203,12/6/21
2210,0,5,4,9,CRAZE13,1224,12/6/21
2211,0,4,3,7,CRAZE46,1209,12/6/21
2212,0,5,5,10,COBRA06,1215,12/6/21
2213,0,4,2,6,CRAZE41,1218,12/6/21
2214,1,4,5,10,CORBRA01,1221,12/6/21
2215,2,3,2,7,WIRE31,1227,12/6/21
2216,1,3,1,5,WIRE32,1230,12/6/21
2217,3,4,5,12,SMALL14,1224,12/6/21
2218,0,3,3,6,RECON77,1403,12/6/21
2219,0,1,2,3,BALL29,1409,12/6/21
2220,2,4,0,6,SMALL67,1433,12/6/21
2221,1,2,3,6,SHINR81,1418,12/6/21
2222,3,2,1,6,SHINR82,1421,12/6/21
2223,0,2,0,2,BALL89,1406,12/6/21
2224,1,3,1,5,VEGA21,1412,12/6/21
2225,1,3,2,6,VEGA22,1412,12/6/21
2226,0,2,1,3,BALL88,1400,12/6/21
2227,0,3,2,5,CRAZE76,1430,12/6/21
2228,1,4,2,7,AXLE11,1424,12/6/21
2229,1,4,2,7,AXLE12,1425,12/6/21
2230,2,3,3,8,CRAZE22,1503,12/6/21
2231,1,3,2,6,COACH21,1436,12/6/21
2232,1,3,2,6,COACH22,1439,12/6/21
2233,0,3,4,7,HOOK67,1445,12/6/21
2234,1,3,3,7,DRAGN66,1442,12/6/21
2235,1,2,5,8,DRAGN22,1448,12/6/21
2236,3,3,3,9,RECON99,1451,12/6/21
2237,1,4,4,9,WIRE31,1457,12/6/21
2238,1,4,5,10,WIRE32,1500,12/6/21
2239,2,3,3,8,EPIC02,1454,12/6/21
2240,2,4,0,6,PHNTM03,1509,12/6/21
2241,0,5,2,7,CRAZE42,1518,12/6/21
2242,0,4,1,5,PHNTM99,1506,12/6/21
2243,2,4,1,7,CRAZE21,1512,12/6/21
2244,3,5,2,10,DRAGN01,1515,12/6/21
2245,0,5,1,6,PHNTM51,1521,12/6/21
2246,0,3,0,3,DRAGN52,1524,12/6/21
2247,0,5,2,7,HOOK16,1527,12/6/21
2248,0,2,5,7,HOOK19,1530,12/6/21
2249,1,0,0,1,GHOST61,1721,12/6/21
2250,1,2,2,5,PHNTM51,1718,12/6/21
2251,1,2,5,8,WIRE31,800,12/7/21
2252,4,2,4,10,DRAGN86,809,12/7/21
2253,3,3,1,7,SMALL61,815,12/7/21
2254,0,0,4,4,HOOK22,806,12/7/21
2255,1,3,4,8,SCARE77,827,12/7/21
2256,2,4,3,9,PHNTM98,812,12/7/21
2257,1,1,4,6,PHNTM03,818,12/7/21
2258,0,2,1,3,CRAZE13,824,12/7/21
2259,1,2,2,5,EASY89,831,12/7/21
2260,2,3,7,12,DAWG01,833,12/7/21
2261,0,3,4,7,PHNTM50,830,12/7/21
2262,2,4,4,10,GHOST48,836,12/7/21
2263,1,3,2,6,SCARE75,839,12/7/21
2264,0,4,4,8,COBRA08,845,12/7/21
2265,0,2,2,4,GHOST02,848,12/7/21
2266,1,1,2,4,COBRA05,851,12/7/21
2267,0,4,4,8,COBRA06,854,12/7/21
2268,0,4,4,8,CRAZE34,842,12/7/21
2269,3,2,1,6,SMALL04,900,12/7/21
2270,1,4,3,8,RECON72,857,12/7/21
2271,2,4,2,8,RECON05,903,12/7/21
2272,1,2,0,3,AXLE11,906,12/7/21
2273,1,2,0,3,AXLE12,909,12/7/21
2274,1,2,0,3,VEGA21,912,12/7/21
2275,1,2,1,4,VEGA22,915,12/7/21
2276,1,4,1,6,SMALL17,933,12/7/21
2277,0,1,1,2,AMMO01,927,12/7/21
2278,1,1,2,4,COACH21,918,12/7/21
2279,1,1,1,3,COACH22,921,12/7/21
2280,0,5,5,10,DRAGN77,936,12/7/21
2281,1,1,2,4,BALL15,930,12/7/21
2282,1,1,0,2,HANG51,939,12/7/21
2283,1,1,0,2,HANG52,942,12/7/21
2284,1,1,3,5,ETCH41,945,12/7/21
2285,1,1,3,5,ETCH42,948,12/7/21
2286,0,1,2,3,BALL27,951,12/7/21
2287,1,3,1,5,TORA81,954,12/7/21
2288,1,3,0,4,TORA82,957,12/7/21
2289,1,4,3,8,HOODOO1,1012,12/7/21
2290,1,4,4,9,HOODOO2,1015,12/7/21
2291,2,5,0,7,PHNTM55,1006,12/7/21
2292,1,3,1,5,TORA21,1000,12/7/21
2293,1,3,1,5,TORA22,1003,12/7/21
2294,4,2,0,6,GIZMO71,1018,12/7/21
2295,4,0,1,5,GIZMO72,1021,12/7/21
2296,2,4,4,10,SLOW11,1024,12/7/21
2297,1,4,1,6,SLOW12,1027,12/7/21
2298,0,2,1,3,HOOK21,924,12/7/21
2299,2,3,4,9,LOST11,1030,12/7/21
2300,2,3,2,7,LOST12,1033,12/7/21
2301,1,3,3,7,DRAGN66,1103,12/7/21
2302,3,4,2,9,HOOK01,1100,12/7/21
2303,1,2,1,4,DRAGN61,1109,12/7/21
2304,0,4,2,6,PAWS86,1106,12/7/21
2305,0,3,1,4,DRAGN69,1112,12/7/21
2306,0,2,0,2,CRAZE43,1118,12/7/21
2307,2,4,2,8,GIZMO11,1121,12/7/21
2308,2,4,2,8,GIZMO12,1121,12/7/21
2309,2,1,3,6,CRAZE09,1048,12/7/21
2310,0,3,3,6,PAWS13,1124,12/7/21
2311,0,2,1,3,DRAGN05,1115,12/7/21
2312,0,3,0,3,BALL76,1133,12/7/21
2313,0,1,1,2,CRAZE21,1127,12/7/21
2314,2,4,2,8,SMALL73,1145,12/7/21
2315,0,3,5,8,DRAGN86,1203,12/7/21
2316,0,2,0,2,RECON01,1151,12/7/21
2317,3,1,1,5,SMALL06,1206,12/7/21
2318,2,4,8,14,BALL41,1148,12/7/21
2319,2,3,7,12,HANG51,1154,12/7/21
2320,4,3,6,13,HANG52,1157,12/7/21
2321,3,4,4,11,DRAGN22,1200,12/7/21
2322,3,1,2,6,SMALL12,1212,12/7/21
2323,2,4,1,7,SMALL13,1221,12/7/21
2324,3,4,3,10,SMALL10,1218,12/7/21
2325,2,2,3,7,DAWG05,1215,12/7/21
2326,0,4,1,5,PHNTM61,1230,12/7/21
2327,4,6,4,14,SPOT91,1233,12/7/21
2328,0,1,2,3,CRAZE88,1227,12/7/21
2329,0,3,2,5,CRAZE55,1239,12/7/21
2330,0,1,6,7,DRAGN32,1209,12/7/21
2331,1,2,0,3,BALL69,1403,12/7/21
2332,1,1,0,2,COACH21,1409,12/7/21
2333,1,1,2,4,COACH22,1409,12/7/21
2334,0,1,1,2,BADGR02,1415,12/7/21
2335,1,3,1,5,PAWS41,1400,12/7/21
2336,0,4,1,5,RECON88,1406,12/7/21
2337,1,3,3,7,WIRE31,1418,12/7/21
2338,3,3,0,6,WIRE32,1418,12/7/21
2339,3,1,1,5,CREEP31,1424,12/7/21
2340,1,3,6,10,DRAGN62,1445,12/7/21
2341,0,3,4,7,BALL08,1430,12/7/21
2342,0,4,8,12,HOOK67,1442,12/7/21
2343,2,3,3,8,DRAGN07,1433,12/7/21
2344,2,1,6,9,DRAGN66,1439,12/7/21
2345,1,4,1,6,STAB11,1448,12/7/21
2346,1,2,4,7,SHINER81,1454,12/7/21
2347,1,0,3,4,HOOK44,1500,12/7/21
2348,1,6,2,9,SCARE12,1521,12/7/21
2349,1,1,2,4,POST61,1503,12/7/21
2350,0,2,0,2,CRAZE42,1515,12/7/21
2351,0,2,4,6,RECON09,1512,12/7/21
2352,3,3,3,9,FIll98,1527,12/7/21
2353,3,3,1,7,FILL99,1530,12/7/21
2354,2,0,1,3,ball81,1506,12/7/21
2355,2,0,1,3,ball82,1510,12/7/21
2356,3,4,1,8,loot51,1724,12/7/21
2357,1,2,0,3,CRAZE54,1727,12/7/21
2358,1,1,1,3,CRAZE42,1730,12/7/21
2359,1,2,2,5,recon88,1718,12/7/21
2360,2,3,3,8,hook51,1721,12/7/21
2361,0,1,5,6,DRAGN62,800,12/8/21
2362,2,3,1,6,SMALL54,800,12/8/21
2363,1,1,7,9,DRAGN24,803,12/8/21
2364,1,1,8,10,DRAGN32,812,12/8/21
2365,2,3,6,11,DRAGN39,815,12/8/21
2366,0,3,2,5,DRAGN35,809,12/8/21
2367,0,3,7,10,PHNTM50,821,12/8/21
2368,1,3,0,4,Easy89,0,12/8/21
2369,1,3,3,7,Looker1,0,12/8/21
2370,1,1,5,7,DRAGN38,818,12/8/21
2371,0,3,1,4,CRAZY88,830,12/8/21
2372,1,3,3,7,SCARE71,836,12/8/21
2373,0,4,2,6,CRAZE46,845,12/8/21
2374,2,1,2,5,SMALL74,848,12/8/21
2375,0,3,4,7,COBRA08,839,12/8/21
2376,0,0,0,0,DRAGN38,818,12/8/21
2377,1,3,4,8,SCARE73,842,12/8/21
2378,1,1,3,5,VEGA51,854,12/8/21
2379,0,3,2,5,RECON05,851,12/8/21
2380,0,1,3,4,Ball89,909,12/8/21
2381,1,1,1,3,Axle41,900,12/8/21
2382,2,1,3,6,SMALL12,918,12/8/21
2383,1,1,3,5,COACH21,912,12/8/21
2384,0,2,1,3,Ball08,906,12/8/21
2385,0,2,3,5,DRAGN51,924,12/8/21
2386,0,1,1,2,DRAGN77,927,12/8/21
2387,2,3,0,5,SMALL20,936,12/8/21
2388,0,2,1,3,DRAGN75,930,12/8/21
2389,1,3,1,5,BALL25,933,12/8/21
2390,2,2,1,5,HOOK12,921,12/8/21
2391,1,2,3,6,TAUNT81,945,12/8/21
2392,2,3,3,8,GIZMO71,954,12/8/21
2393,2,3,4,9,TAUNT61,951,12/8/21
2394,2,1,4,7,TORA11,1000,12/8/21
2395,2,2,5,9,Hook66,1009,12/8/21
2396,0,3,5,8,HOOK17,1006,12/8/21
2397,0,1,6,7,HOOK72,1015,12/8/21
2398,0,3,4,7,HOOK03,1018,12/8/21
2399,0,2,0,2,DRAGN69,1103,12/8/21
2400,1,1,1,3,EASY89,1030,12/8/21
2401,3,1,0,4,DRAGN65,1100,12/8/21
2402,3,4,0,7,Small63,1121,12/8/21
2403,1,1,1,3,WIRE91,1109,12/8/21
2404,2,1,1,4,DRAGN05,1124,12/8/21
2405,0,1,1,2,FURY01,1118,12/8/21
2406,1,3,1,5,PHNTM99,0,12/8/21
2407,1,2,2,5,Ball62,1115,12/8/21
2408,0,2,2,4,HOOK61,1112,12/8/21
2409,1,1,1,3,SCARE26,1136,12/8/21
2410,0,0,1,1,CRAZE21,1127,12/8/21
2411,1,2,3,6,ETCH21,1130,12/8/21
2412,1,2,6,9,ETCH21,1130,12/8/21
2413,1,1,6,8,DRAGN39,1203,12/8/21
2414,1,3,9,13,DRAGN32,1200,12/8/21
2415,3,0,5,8,SMALL11,1215,12/8/21
2416,0,1,4,5,DAWG01,1218,12/8/21
2417,1,0,1,2,HANG31,1209,12/8/21
2418,1,0,1,2,HANG31,1209,12/8/21
2419,0,2,1,3,PAWS22,1230,12/8/21
2420,1,0,6,7,DRAGN38,1206,12/8/21
2421,0,2,5,7,DAWG05,1221,12/8/21
2422,2,3,7,12,BALL42,1224,12/8/21
2423,2,0,5,7,DAWG04,1227,12/8/21
2424,2,2,0,4,LOADED41,1400,12/8/21
2425,2,2,8,12,LODED41,0,12/8/21
2426,2,0,4,6,BADGER02,1403,12/8/21
2427,1,0,2,3,SPOT91,1409,12/8/21
2428,1,0,3,4,SPOT91,1409,12/8/21
2429,1,0,1,2,STAB11,1415,12/8/21
2430,1,0,2,3,STAB12,1415,12/8/21
2431,1,2,4,7,BALL89,1427,12/8/21
2432,0,0,3,3,AMMO01,1433,12/8/21
2433,1,4,4,9,SCARE16,1439,12/8/21
2434,2,0,2,4,LOOT69,1430,12/8/21
2435,3,0,5,8,DRAGN86,1442,12/8/21
2436,3,0,1,4,SMALL64,1421,12/8/21
2437,0,0,5,5,DRAGN71,1445,12/8/21
2438,0,2,0,2,GHOST53,1451,12/8/21
2439,1,1,5,7,DRAGN05,1503,12/8/21
2440,1,0,2,3,DRAGN65,1448,12/8/21
2441,2,2,0,4,BALL04,1457,12/8/21
2442,3,0,3,6,HOOK02,1315,12/8/21
2443,0,2,3,5,EPIC02,1454,12/8/21
2444,0,2,2,4,HOOK44,1506,12/8/21
2445,2,2,5,9,BALL02,1518,12/8/21
2446,2,2,6,10,DRAGN62,1524,12/8/21
2447,0,0,2,2,FURY04,1527,12/8/21
2448,1,0,4,5,DRAGN61,1621,12/8/21
2449,2,2,1,5,HOOK33,1718,12/8/21
2450,1,0,1,2,BALL18,1721,12/8/21
2451,4,0,5,9,DRAGN38,809,12/9/21
2452,2,2,5,9,DRAGN24,800,12/9/21
2453,2,2,3,7,DRAGN25,80,12/9/21
2454,3,2,4,9,DRAGN86,806,12/9/21
2455,1,3,9,13,STAB11,812,12/9/21
2456,1,3,5,9,STAB12,815,12/9/21
2457,1,0,4,5,LOOT50,827,12/9/21
2458,2,3,3,8,RAGTAG1,821,12/9/21
2459,3,3,3,9,RAGTAG2,824,12/9/21
2460,1,0,3,4,COBRA06,833,12/9/21
2461,0,0,3,3,CRAZE46,836,12/9/21
2462,0,0,1,1,CRAZE34,830,12/9/21
2463,1,0,1,2,SMALL71,839,12/9/21
2464,1,1,0,2,BALL41,818,12/9/21
2465,1,2,4,7,COBRA02,842,12/9/21
2466,0,0,2,2,GHOST02,845,12/9/21
2467,1,0,6,7,COBRA08,848,12/9/21
2468,2,0,5,7,BALL35,0,12/9/21
2469,1,1,1,3,LOADED1,854,12/9/21
2470,1,1,1,3,LOADED2,857,12/9/21
2471,1,0,0,1,SPOT91,906,12/9/21
2472,3,0,0,3,SPOT92,909,12/9/21
2473,1,2,1,4,CREEP31,900,12/9/21
2474,1,2,4,7,CREEP32,903,12/9/21
2475,1,0,1,2,AXEL11,912,12/9/21
2476,1,0,1,2,AXEL12,915,12/9/21
2477,1,0,1,2,WIRE31,921,12/9/21
2478,1,0,1,2,WIRE32,924,12/9/21
2479,2,0,3,5,BADGR09,918,12/9/21
2480,0,2,6,8,BALL89,927,12/9/21
2481,0,0,4,4,CRAZE76,930,12/9/21
2482,2,2,2,6,LOST11,951,12/9/21
2483,3,0,0,3,LOST12,954,12/9/21
2484,2,2,0,4,SLOW11,1009,12/9/21
2485,1,2,2,5,SLOW12,1012,12/9/21
2486,4,1,6,11,PAWS43,936,12/9/21
2487,0,2,2,4,HOOK44,1003,12/9/21
2488,0,1,1,2,DRAGN05,1006,12/9/21
2489,1,2,4,7,FILL11,945,12/9/21
2490,1,2,2,5,FILL12,948,12/9/21
2491,1,3,3,7,GIZMO31,1015,12/9/21
2492,1,3,6,10,GIZMO32,1018,12/9/21
2493,1,0,3,4,DRAGN29,957,12/9/21
2494,3,0,5,8,DRAGN62,1109,12/9/21
2495,0,2,2,4,HOOK17,1100,12/9/21
2496,0,2,2,4,DRAGN75,1033,12/9/21
2497,0,2,1,3,HOOK77,1106,12/9/21
2498,0,2,2,4,HOOK61,1121,12/9/21
2499,1,2,3,6,DRAGN66,1112,12/9/21
2500,1,0,5,6,DRAGN67,1118,12/9/21
2501,0,2,1,3,PAWS12,1124,12/9/21
2502,4,2,8,14,CRAZE45,1133,12/9/21
2503,1,0,1,2,DRAGN99,1142,12/9/21
2504,0,0,1,1,RECON03,1127,12/9/21
2505,2,0,2,4,CRAZE09,1139,12/9/21
2506,1,3,6,10,SHINR81,1151,12/9/21
2507,1,3,5,9,SHINR82,1154,12/9/21
2508,2,0,4,6,DRAGN33,1145,12/9/21
2509,3,2,1,6,HOOK01,1136,12/9/21
2510,2,0,2,4,DRAGN22,1157,12/9/21
2511,1,0,5,6,CRAZY33,1200,12/9/21
2512,1,0,0,1,DRAGN35,1203,12/9/21
2513,0,2,1,3,CRAZE88,1209,12/9/21
2514,1,2,10,13,FILL99,1206,12/9/21
2515,0,3,2,5,DAWG01,1215,12/9/21
2516,2,0,2,4,GHOST48,1218,12/9/21
2517,0,0,5,5,COBRA06,1221,12/9/21
2518,0,2,2,4,PAWS41,1409,12/9/21
2519,0,0,6,6,RECON09,1227,12/9/21
2520,0,0,2,2,PHNTM50,1212,12/9/21
2521,2,0,2,4,SMALL16,1230,12/9/21
2522,1,2,4,7,PAWS46,1233,12/9/21
2523,0,2,4,6,COBRA05,1404,12/9/21
2524,1,0,2,3,SCARE71,1415,12/9/21
2525,1,0,5,6,RAGTAG011,1400,12/9/21
2526,1,0,2,3,RAGTAG02,1403,12/9/21
2527,2,0,4,6,SMALL60,1412,12/9/21
2528,1,1,0,2,BALL05,1406,12/9/21
2529,1,0,1,2,STAB01,1418,12/9/21
2530,1,0,1,2,STAB02,1421,12/9/21
2531,1,2,6,9,BALL89,1436,12/9/21
2532,1,0,3,4,COACH21,1424,12/9/21
2533,1,0,3,4,COACH22,1427,12/9/21
2534,1,0,1,2,SCARE72,1430,12/9/21
2535,0,2,7,9,BALL18,1432,12/9/21
2536,0,2,2,4,DRAGN02,1439,12/9/21
2537,1,3,2,6,SCARE19,1445,12/9/21
2538,2,0,5,7,DRAGN43,1606,12/9/21
2539,3,2,5,10,DRAGN66,1448,12/9/21
2540,0,2,5,7,HOOK71,1442,12/9/21
2541,0,2,3,5,DRAGN61,1457,12/9/21
2542,1,0,2,3,VEGA21,1500,12/9/21
2543,1,0,2,3,VEGA22,1503,12/9/21
2544,0,0,6,6,DRAGN67,1454,12/9/21
2545,4,0,1,5,SMALL75,1451,12/9/21
2546,0,2,3,5,DRAGN05,1512,12/9/21
2547,2,0,0,2,SMALL06,1506,12/9/21
2548,2,0,2,4,SMALL11,1515,12/9/21
2549,0,2,5,7,HOOK17,1521,12/9/21
2550,0,1,0,1,CRAZE21,1509,12/9/21
2551,0,3,3,6,DRAGN33,1518,12/9/21
2552,2,0,2,4,SMALL 14,1524,12/9/21
2553,0,0,2,2,BALL63,1530,12/9/21
2554,3,0,0,3,HOOK59,1718,12/9/21
2555,0,5,7,12,DRAGN86,803,12/10/21
2556,2,7,5,14,DRAGN24,806,12/10/21
2557,1,6,1,8,CREEP31,806,12/10/21
2558,1,6,2,9,CREEP32,806,12/10/21
2559,0,8,5,13,GHOST48,824,12/10/21
2560,3,6,2,11,SMALL67,833,12/10/21
2561,0,2,0,2,RHINO99,800,12/10/21
2562,0,2,2,4,CRAZE41,830,12/10/21
2563,2,8,4,14,BALL35,845,12/10/21
2564,3,6,2,11,PAWS46,845,12/10/21
2565,1,5,7,13,BALL82,857,12/10/21
2566,2,5,11,18,DRAGN32,842,12/10/21
2567,2,4,2,8,DRAGN05,900,12/10/21
2568,1,6,1,8,STAB11,909,12/10/21
2569,1,6,1,8,STAB12,912,12/10/21
2570,1,6,3,10,WIRE31,921,12/10/21
2571,1,6,0,7,WIRE32,924,12/10/21
2572,1,9,0,10,CRAZE21,906,12/10/21
2573,2,8,2,12,CRAZE42,1112,12/10/21
2574,1,2,2,5,ETCH41,1103,12/10/21
2575,1,2,0,3,ETCH42,1106,12/10/21
2576,2,5,6,13,TORA11,1156,12/10/21
2577,2,5,0,7,TORA12,1139,12/10/21
2578,1,2,0,3,BALL75,1142,12/10/21
2579,0,3,2,5,PAWS69,1145,12/10/21
2580,1,10,1,12,LOOT06,1124,12/10/21
2581,3,4,2,9,BALL87,1121,12/10/21
2582,1,11,2,14,BALL18,1127,12/10/21
2583,2,9,3,14,BALL09,1133,12/10/21
2584,1,2,0,3,HOOK59,1206,12/10/21
2585,1,4,1,6,LOOT55,1203,12/10/21
2586,1,5,8,14,CRAZE46,1251,12/10/21
2587,1,3,4,8,BALL27,1245,12/10/21
2588,2,10,2,14,BALL15,1130,12/10/21
2589,1,7,2,10,BALL44,1230,12/10/21
2590,1,8,0,9,BALL45,1445,12/10/21
2591,1,1,0,2,PAWS88,1500,12/10/21
2592,1,7,2,10,BALL41,1503,12/10/21
2593,0,2,5,7,PAWS46,736,12/13/21
2594,2,0,3,5,SMALL45,739,12/13/21
2595,2,3,6,11,DAWG05,7420,12/13/21
2596,0,3,3,6,CRAZE88,748,12/13/21
2597,2,2,4,8,DAWG02,745,12/13/21
2598,0,5,3,8,DRAGN77,951,12/13/21
2599,2,3,6,11,DRAGN62,757,12/13/21
2600,1,3,4,8,DRAGN66,754,12/13/21
2601,0,4,2,6,EVIL02,800,12/13/21
2602,1,4,2,7,DRAGN69,751,12/13/21
2603,1,1,4,6,WIRE31,812,12/13/21
2604,0,3,2,5,DRAGN03,857,12/13/21
2605,1,3,3,7,DRAGN99,827,12/13/21
2606,2,3,1,6,SMALL64,824,12/13/21
2607,0,2,3,5,LOOT69,821,12/13/21
2608,1,5,6,12,VEGA21,836,12/13/21
2609,0,3,0,3,Ball69,833,12/13/21
2610,1,3,4,8,GIZMO61,845,12/13/21
2611,0,2,1,3,BALL89,851,12/13/21
2612,3,3,3,9,AMMO04,842,12/13/21
2613,0,4,4,8,PAWS07,900,12/13/21
2614,2,2,2,6,FILL21,921,12/13/21
2615,2,7,4,13,Fill22,924,12/13/21
2616,1,5,2,8,LOST11,915,12/13/21
2617,1,5,4,10,LOST12,918,12/13/21
2618,1,5,5,11,BALL44,912,12/13/21
2619,1,4,1,6,PAWS16,930,12/13/21
2620,1,3,2,6,RAGTAG1,903,12/13/21
2621,1,4,1,6,BALL22,927,12/13/21
2622,1,3,2,6,RAGTAG2,906,12/13/21
2623,1,3,1,5,LOADED1,945,12/13/21
2624,1,3,1,5,LOADED2,948,12/13/21
2625,1,6,8,15,GIZAMO21,939,12/13/21
2626,1,6,3,10,GIZMO22,942,12/13/21
2627,2,4,1,7,TORA21,933,12/13/21
2628,2,4,0,6,TORA22,936,12/13/21
2629,2,3,3,8,CRAZE22,1036,12/13/21
2630,0,5,3,8,DRAGN05,1030,12/13/21
2631,2,3,1,6,PAWS42,1045,12/13/21
2632,3,4,3,10,SCARE15,1033,12/13/21
2633,2,3,1,6,SMALL51,1051,12/13/21
2634,2,2,0,4,SMALL50,1048,12/13/21
2635,0,3,0,3,DRGN41,1039,12/13/21
2636,1,4,0,5,SCARE,1042,12/13/21
2637,2,3,0,5,SMALL57,1109,12/13/21
2638,3,4,4,11,STAB 11,1054,12/13/21
2639,1,2,1,4,STAB 12,1057,12/13/21
2640,1,3,2,6,DRAGN59,1100,12/13/21
2641,0,3,6,9,COBRA05,1112,12/13/21
2642,1,3,6,10,CRAZE48,1118,12/13/21
2643,0,3,7,10,COBRA08,1121,12/13/21
2644,0,2,4,6,PAWS46,1115,12/13/21
2645,0,2,3,5,CRAZE07,1106,12/13/21
2646,0,3,3,6,BALL82,1124,12/13/21
2647,2,2,2,6,CRAZE88,1127,12/13/21
2648,2,3,7,12,DRAGN62,1136,12/13/21
2649,0,2,0,2,GHOST02,1130,12/13/21
2650,0,3,7,10,DRAGN66,1142,12/13/21
2651,0,3,5,8,HOOK03,1145,12/13/21
2652,0,2,5,7,DRAGN71,1142,12/13/21
2653,1,3,1,5,ETCH41,1151,12/13/21
2654,3,5,1,9,ETCH42,1154,12/13/21
2655,1,3,1,5,CREEP31,1150,12/13/21
2656,1,3,2,6,CREEP32,1155,12/13/21
2657,0,0,3,3,DRAGN07,1139,12/13/21
2658,1,2,3,6,SCARE69,1330,12/13/21
2659,1,2,1,4,SCARE77,1345,12/13/21
2660,1,2,1,4,CRAZE61,1333,12/13/21
2661,1,2,2,5,COACH21,1354,12/13/21
2662,1,0,1,2,VEGA22/21,13390,12/13/21
2663,2,3,3,8,FURY02,1348,12/13/21
2664,1,3,3,7,BALL27,1336,12/13/21
2665,0,3,1,4,GHOST69,1400,12/13/21
2666,3,1,1,5,SMALL55,1403,12/13/21
2667,5,0,0,5,FURY01,1357,12/13/21
2668,3,2,1,6,DRAGN17,1418,12/13/21
2669,0,0,2,2,HOOK22,1412,12/13/21
2670,1,1,2,4,DUKE16,1415,12/13/21
2671,1,3,4,8,WIRE31,1424,12/13/21
2672,1,3,4,8,WIRE32,1427,12/13/21
2673,0,2,5,7,PHTM45,1433,12/13/21
2674,1,3,2,6,RENO71,1436,12/13/21
2675,1,2,0,3,DRAGN35,1430,12/13/21
2676,1,0,3,4,CRAZY28,1442,12/13/21
2677,1,1,1,3,AXLE11,1406,12/13/21
2678,1,1,2,4,AXLE12,1409,12/13/21
2679,0,2,2,4,RECON73,1421,12/13/21
2681,0,5,2,7,PAWS11,942,12/15/21
2682,0,1,2,3,BALL82,1118,12/15/21
2684,1,2,5,8,SCARE77,730,12/16/21
2685,1,1,3,5,SCARE37,733,12/16/21
2686,0,2,8,10,COBRA01,736,12/16/21
2687,0,1,6,7,BALL82,739,12/16/21
2688,0,3,6,9,CRAZE46,742,12/16/21
2689,0,3,8,11,COBRA06,748,12/16/21
2690,0,3,8,11,COBRA08,745,12/16/21
2691,0,3,5,8,BALL44,751,12/16/21
2692,0,2,3,5,DAWG05,754,12/16/21
2693,2,3,5,10,WIRE31,800,12/16/21
2694,2,3,4,9,WIRE32,800,12/16/21
2695,1,2,6,9,DRAGN62,757,12/16/21
2696,2,2,4,8,DRAGN61,806,12/16/21
2697,1,3,0,4,Easy42,801,12/16/21
2698,1,4,4,9,SCARE59,809,12/16/21
2699,0,2,7,9,DRAGN77,812,12/16/21
2700,1,3,4,8,COACH21,821,12/16/21
2701,1,3,2,6,COACH22,821,12/16/21
2702,0,3,2,5,LOOT06,818,12/16/21
2703,1,2,2,5,SPOT91,827,12/16/21
2704,1,2,0,3,SPOT92,830,12/16/21
2705,2,1,3,6,EPIC07,845,12/16/21
2706,1,2,3,6,GOLEM21,839,12/16/21
2707,2,1,1,4,CRAZE61,854,12/16/21
2708,1,2,2,5,VEGA21,833,12/16/21
2709,1,2,2,5,VEGA22,836,12/16/21
2710,3,2,4,9,RECON01,815,12/16/21
2711,4,4,2,10,FURY04,851,12/16/21
2712,2,2,1,5,EPIC08,857,12/16/21
2713,3,2,1,6,FURY01,854,12/16/21
2714,1,2,0,3,EASY89,834,12/16/21
2715,2,3,2,7,HANG51,900,12/16/21
2716,2,3,0,5,HANG52,903,12/16/21
2717,1,3,4,8,LOOKER1,906,12/16/21
2718,1,3,4,8,LOOKER2,909,12/16/21
2719,0,2,3,5,CRAZE22,939,12/16/21
2720,1,2,6,9,LOST11,918,12/16/21
2721,1,2,2,5,LOST12,921,12/16/21
2722,0,2,6,8,HOOK51,915,12/16/21
2723,1,3,3,7,TORA11,930,12/16/21
2724,1,3,2,6,TORA12,933,12/16/21
2725,1,3,0,4,RECON71,936,12/16/21
2726,1,2,1,4,DRAGN15,945,12/16/21
2727,1,1,0,2,TAUNT11,942,12/16/21
2728,1,3,1,5,RECON79,1000,12/16/21
2729,1,2,3,6,GIZMO11,951,12/16/21
2730,1,2,1,4,GIZMO12,954,12/16/21
2731,2,1,2,5,PAWS11,942,12/16/21
2732,0,2,5,7,TAUNT11,942,12/16/21
2733,1,2,5,8,TAUNT12,948,12/16/21
2734,1,3,1,5,BALL42,912,12/16/21
2735,1,2,0,3,PAWS81,924,12/16/21
2736,1,2,1,4,PAWS82,927,12/16/21
2737,0,2,4,6,PHNTM99,1030,12/16/21
2738,2,3,1,6,AXLE11,1033,12/16/21
2739,2,3,1,6,AXLE12,1036,12/16/21
2740,0,2,2,4,DRAGN05,1042,12/16/21
2741,1,3,2,6,STAB11,1048,12/16/21
2742,1,3,4,8,STAB12,1051,12/16/21
2743,2,3,2,7,CRAZE55,1039,12/16/21
2744,0,2,4,6,HOOK39,1054,12/16/21
2745,2,2,3,7,DRAGN31,942,12/16/21
2746,2,3,2,7,DRAGN26,1100,12/16/21
2747,2,3,0,5,HOOK33,1045,12/16/21
2748,1,3,0,4,VEGA21,1103,12/16/21
2749,1,3,3,7,VEGA22,1103,12/16/21
2750,1,3,2,6,COBRA05,1121,12/16/21
2751,3,2,3,8,SCARE73,1139,12/16/21
2752,2,3,2,7,HANG51,1130,12/16/21
2753,0,2,9,11,CRAZE46,1115,12/16/21
2754,2,2,2,6,SMALL72,1142,12/16/21
2755,1,2,2,5,SCARE72,1136,12/16/21
2756,0,3,3,6,PHNTM45,1145,12/16/21
2757,1,3,1,5,DRAGN07,1151,12/16/21
2758,4,3,1,8,DRAGN71,1154,12/16/21
2759,1,4,4,9,Ball45,1142,12/16/21
2760,1,5,2,8,EASY89,1201,12/16/21
2761,2,3,4,9,craze43,1200,12/16/21
2762,2,3,3,8,BALL15,1315,12/16/21
2763,2,4,2,8,BALL18,1230,12/16/21
2764,2,3,4,9,RAGTAG1,1333,12/16/21
2765,1,3,1,5,BALL01,1330,12/16/21
2766,1,2,2,5,BADGER09,1345,12/16/21
2767,1,2,3,6,COACH 21,1351,12/16/21
2768,1,2,3,6,COACH22,1351,12/16/21
2769,2,4,2,8,BALL02,1348,12/16/21
2770,2,1,1,4,SMALL60,1412,12/16/21
2771,3,2,3,8,HOOK15,1400,12/16/21
2772,5,2,1,8,RECON04,1406,12/16/21
2773,2,2,2,6,STAB11,1415,12/16/21
2774,2,2,2,6,STAB12,1415,12/16/21
2775,2,3,2,7,PHANTM99,1421,12/16/21
2776,3,2,1,6,DRAGN12,1436,12/16/21
2777,2,0,1,3,ETCH41,1430,12/16/21
2778,2,2,3,7,LOADED01,1445,12/16/21
2779,1,3,2,6,WIRE31,1439,12/16/21
2780,1,2,1,4,Axle11,1457,12/16/21
2781,1,2,2,5,Axle12,1500,12/16/21
2782,2,2,2,6,BALL19,1730,12/16/21
2783,1,0,1,2,DRAGN71,1712,12/16/21
2784,0,2,1,3,recon73,745,12/17/21
2785,0,2,9,11,cobra08,733,12/17/21
2786,0,2,4,6,ball69,754,12/17/21
2787,1,4,8,13,craze48,739,12/17/21
2788,2,2,4,8,FURY01,748,12/17/21
2789,0,2,7,9,CRAZE46,736,12/17/21
2790,1,3,6,10,COBRA06,742,12/17/21
2791,0,1,3,4,CRAZE34,751,12/17/21
2792,1,4,5,10,DRAGN62,806,12/17/21
2793,0,2,4,6,DAWG02,800,12/17/21
2794,1,2,4,7,SHINR81,812,12/17/21
2795,1,2,4,7,SHINR82,815,12/17/21
2796,2,5,6,13,DRAGN51,824,12/17/21
2797,0,4,6,10,DRAGN68,818,12/17/21
2798,0,2,6,8,DRAGN72,821,12/17/21
2799,1,2,3,6,COACH21,827,12/17/21
2800,1,2,1,4,COACH22,827,12/17/21
2801,1,5,2,8,PHNTM45,809,12/17/21
2802,1,3,1,5,EASY86,831,12/17/21
2803,0,4,2,6,BALL45,803,12/17/21
2804,3,2,0,5,CRAZE42,909,12/17/21
2805,2,2,1,5,RHINO99,730,12/17/21
2806,2,4,1,7,ETCH41,845,12/17/21
2807,2,4,3,9,ETCH42,848,12/17/21
2808,3,4,3,10,VEGA21,839,12/17/21
2809,2,4,2,8,VEGA22,839,12/17/21
2810,0,3,0,3,EPIC05,854,12/17/21
2811,1,2,1,4,CRAZE54,900,12/17/21
2812,2,2,4,8,EPIC06,857,12/17/21
2813,1,2,1,4,DRAGN91,906,12/17/21
2814,1,1,4,6,BALL82,903,12/17/21
2815,2,2,3,7,TAUNT11,912,12/17/21
2816,1,2,2,5,TAUNT12,912,12/17/21
2817,1,2,2,5,LOOKER1,918,12/17/21
2818,1,2,1,4,LOOKER2,921,12/17/21
2819,1,3,2,6,HOOK86,930,12/17/21
2820,2,4,0,6,WIRE31,939,12/17/21
2821,1,4,1,6,WIRE32,939,12/17/21
2822,1,4,5,10,TAUNT21,932,12/17/21
2823,1,4,1,6,TAUNT22,936,12/17/21
2824,2,2,3,7,TORA11,924,12/17/21
2825,2,2,3,7,TORA12,927,12/17/21
2826,2,2,1,5,CRAZE45,1039,12/17/21
2827,0,2,0,2,CRAZE09,1051,12/17/21
2828,1,5,2,8,SHINR81,1042,12/17/21
2829,1,1,0,2,CRAZE61,1033,12/17/21
2830,2,3,1,6,GHOST69,1036,12/17/21
2831,0,4,1,5,DRAGN43,1048,12/17/21
2832,1,5,1,7,STAB11,1103,12/17/21
2833,1,5,3,9,STAB12,1106,12/17/21
2834,4,4,2,10,PHNTM51,1100,12/17/21
2835,0,0,1,1,PAWS11,948,12/17/21
2836,1,2,2,5,DRAGN59,1054,12/17/21
2837,2,7,3,12,PHIL41,1109,12/17/21
2838,2,7,1,10,PHIL42,1112,12/17/21
2839,1,3,2,6,DRAGN07,1136,12/17/21
2840,1,2,7,10,PAWS46,1115,12/17/21
2841,0,2,2,4,DAWG05,1133,12/17/21
2842,2,2,5,9,DRAGN12,1139,12/17/21
2843,4,2,1,7,FURY08,1127,12/17/21
2844,1,4,2,7,BALL42,1130,12/17/21
2845,0,5,5,10,DRAGN66,1142,12/17/21
2846,1,4,2,7,HANG51,1115,12/17/21
2847,1,4,2,7,HANG52,1118,12/17/21
2848,0,3,5,8,DRAGN68,1154,12/17/21
2849,0,2,5,7,HOOK72,1157,12/17/21
2850,0,2,6,8,BALL19,1203,12/17/21
2851,1,4,0,5,RECON71,1200,12/17/21
2852,0,4,1,5,BALL09,1206,12/17/21
2853,0,2,2,4,CRAZE76,1203,12/17/21
2854,0,2,1,3,GHOST53,1336,12/17/21
2855,3,2,1,6,BALL67,1333,12/17/21
2856,0,2,0,2,PHNTM69,1339,12/17/21
2857,2,6,2,10,CREEP31,1342,12/17/21
2858,1,6,5,12,CREEP32,1345,12/17/21
2859,1,6,2,9,COACH21,1348,12/17/21
2860,1,6,4,11,COACH22,1351,12/17/21
2861,2,2,2,6,CRAZE43,1357,12/17/21
2862,2,3,3,8,HOOK86,1403,12/17/21
2863,0,6,2,8,BALL28,1354,12/17/21
2864,2,2,3,7,RECON03,1409,12/17/21
2865,2,2,2,6,FURY02,1412,12/17/21
2866,0,2,5,7,CRAZE14,1406,12/17/21
2867,1,7,4,12,DRAGON05,1418,12/17/21
2868,4,2,1,7,SMALL65,1427,12/17/21
2869,3,2,1,6,SMALL67,1433,12/17/21
2870,0,3,3,6,DRAGON36,1418,12/17/21
2871,3,2,5,10,SMALL64,1424,12/17/21
2872,1,2,1,4,SCARE72,1415,12/17/21
2873,3,4,3,10,EVIL02,1430,12/17/21
2874,1,2,4,7,DRAGON35,1400,12/17/21
2875,2,5,2,9,DRAGON38,1436,12/17/21
2876,1,8,3,12,LOADED1/,1451,12/17/21
2877,1,8,3,12,LOADED2,1454,12/17/21
2878,0,2,0,2,DRAGON61,1445,12/17/21
2879,2,3,3,8,LOOKER2,1457,12/17/21
2880,1,3,0,4,VEGA21/,1439,12/17/21
2881,1,3,4,8,VEGA22,1442,12/17/21
2882,2,3,5,10,LOOKER1,1500,12/17/21
2883,2,2,3,7,HOOK32/,1503,12/17/21
2884,2,3,5,10,HOOK62,1448,12/17/21
2885,1,3,2,6,PHANTOM55,1506,12/17/21
2886,2,3,2,7,hook38,806,12/20/21
2887,3,3,3,9,Hook66,803,12/20/21
2888,3,2,2,7,Hook01,827,12/20/21
2889,4,4,3,11,SHINR81,848,12/20/21
2890,2,4,3,9,SHINR82,848,12/20/21
2891,0,4,7,11,PHNTM45,909,12/20/21
2892,4,3,3,10,EVIL02,915,12/20/21
2893,2,3,5,10,DRAGN13,912,12/20/21
2894,1,3,0,4,TAUNT11,903,12/20/21
2895,3,4,1,8,HANG51,918,12/20/21
2896,3,4,2,9,HANG52,921,12/20/21
2897,3,3,2,8,TORA11,936,12/20/21
2898,1,3,2,6,TORA12,939,12/20/21
2899,1,1,1,3,FILL21,948,12/20/21
2900,1,1,6,8,FILL22,951,12/20/21
2901,1,5,4,10,LOOKER1,900,12/20/21
2902,1,3,0,4,LOOKER2,933,12/20/21
2903,0,4,4,8,HOOK71,800,12/20/21
2904,1,3,4,8,GIZMO11,954,12/20/21
2905,3,3,1,7,SLOW11,942,12/20/21
2906,3,3,2,8,SLOW12,945,12/20/21
2907,2,2,3,7,RECON71,1103,12/20/21
2908,0,0,3,3,STAB11,1106,12/20/21
2909,0,0,0,0,STAB12,1109,12/20/21
2910,1,0,0,1,VEGA21,1112,12/20/21
2911,3,0,0,3,VEGA22,1115,12/20/21
2912,3,0,1,4,AXEL11,1118,12/20/21
2913,1,0,0,1,AXEL12,1121,12/20/21
2914,0,1,1,2,RECON01,1127,12/20/21
2915,0,2,2,4,PAWS69,957,12/20/21
2916,0,2,0,2,PAWS54,1133,12/20/21
2917,1,2,2,5,POST61,1139,12/20/21
2918,1,2,1,4,POST62,1142,12/20/21
2919,3,0,7,10,BALL57,1136,12/20/21
2920,4,4,5,13,TORA81,1148,12/20/21
2921,0,2,2,4,BALL73,1151,12/20/21
2922,2,3,0,5,COACH21,1218,12/20/21
2923,2,3,2,7,COACH22,1218,12/20/21
2924,1,3,2,6,RENO71,1224,12/20/21
2925,1,3,3,7,RENO72,1224,12/20/21
2926,2,3,6,11,EPIC06,736,12/21/21
2927,4,3,5,12,RECON03,739,12/21/21
2928,2,3,6,11,GHOST53,733,12/21/21
2929,2,2,6,10,EPIC08,730,12/21/21
2930,4,2,6,12,EPIC07,742,12/21/21
2931,2,3,3,8,CRAZE45,748,12/21/21
2932,2,3,3,8,RECON89,751,12/21/21
2933,0,3,4,7,DRAGN41,803,12/21/21
2934,2,3,3,8,RECON71,754,12/21/21
2935,1,3,6,10,AXLE11,757,12/21/21
2936,1,3,9,13,AXLE12,800,12/21/21
2937,2,3,5,10,STAB11,812,12/21/21
2938,3,3,2,8,STAB12,815,12/21/21
2939,1,4,5,10,HANG51,806,12/21/21
2940,1,4,2,7,HANG52,809,12/21/21
2941,1,3,5,9,BALL81,815,12/21/21
2942,1,4,2,7,TAUNT11,745,12/21/21
2943,1,4,3,8,TAUNT12,745,12/21/21
2944,1,4,6,11,WIRE31,821,12/21/21
2945,1,4,3,8,WIRE32,824,12/21/21
2946,1,3,3,7,VEGA21,830,12/21/21
2947,1,3,5,9,VEGA22,833,12/21/21
2948,1,1,5,7,BALL38,842,12/21/21
2949,1,3,5,9,BALL35,839,12/21/21
2950,0,3,3,6,CRAZE46,845,12/21/21
2951,1,3,4,8,BALL44,848,12/21/21
2952,2,3,7,12,BALL42,854,12/21/21
2953,1,2,6,9,BALL82,848,12/21/21
2954,1,1,1,3,COACH21,857,12/21/21
2955,1,1,1,3,COACH22,900,12/21/21
2956,0,2,5,7,SPECK48,857,12/21/21
2957,0,3,7,10,BALL16,903,12/21/21
2958,2,3,2,7,SLOW21,909,12/21/21
2959,1,3,5,9,SLOW22,912,12/21/21
2960,2,3,4,9,CRAZE09,921,12/21/21
2961,1,3,3,7,SCARE69,924,12/21/21
2962,1,3,2,6,BALL09,906,12/21/21
2963,0,3,1,4,HOOK26,918,12/21/21
2964,3,4,8,15,HOOK52,927,12/21/21
2965,1,3,4,8,LOADED1,924,12/21/21
2966,0,3,4,7,LOADED2,927,12/21/21
2967,1,3,2,6,SPOT91,945,12/21/21
2968,2,3,3,8,SPOT92,948,12/21/21
2969,1,3,1,5,PAWS54,951,12/21/21
2970,1,2,1,4,BALL61,939,12/21/21
2971,1,2,2,5,BALL62,942,12/21/21
2972,0,3,3,6,DRAGN66,1030,12/21/21
2973,2,3,0,5,SMALL45,1039,12/21/21
2974,2,3,0,5,SMALL44,1036,12/21/21
2975,1,3,2,6,SCARE17,1042,12/21/21
2976,2,2,0,4,DRAGN15,1033,12/21/21
2977,0,4,1,5,HOOK75,1048,12/21/21
2978,4,3,1,8,SMALL51,1051,12/21/21
2979,2,3,2,7,CRAZE43,1112,12/21/21
2980,4,3,2,9,FURY08,1127,12/21/21
2982,2,3,5,10,GHOST53,1118,12/21/21
2983,4,3,4,11,RECON03,1121,12/21/21
2984,2,3,0,5,FURY07,1124,12/21/21
2985,2,3,1,6,EPIC02,1109,12/21/21
2986,2,2,6,10,EPIC08,1115,12/21/21
2987,2,2,0,4,FURY01,1130,12/21/21
2988,3,4,5,12,CRAZE42,1145,12/21/21
2989,1,3,7,11,HOOK38,1151,12/21/21
2990,1,3,7,11,AXEL11,1133,12/21/21
2991,3,3,4,10,AXEL12,1133,12/21/21
2992,1,3,9,13,HOOK32,1148,12/21/21
2993,1,3,7,11,STAB11,1139,12/21/21
2994,3,3,5,11,STAB12,1139,12/21/21
2995,1,2,5,8,VEGA21,1206,12/21/21
2996,3,2,3,8,VEGA22,1206,12/21/21
2997,1,3,5,9,BALL35,1221,12/21/21
2998,1,2,3,6,SCARE75,1224,12/21/21
2999,2,2,1,5,HOOK03,1209,12/21/21
3000,2,2,5,9,HANG51,1245,12/21/21
3001,2,2,2,6,HANG52,1245,12/21/21
3002,1,1,1,3,EASY89,1250,12/21/21
3003,0,2,6,8,RECON81,1333,12/21/21
3004,1,2,1,4,BALL19,1345,12/21/21
3005,2,1,1,4,BALL88,1330,12/21/21
3006,2,2,5,9,BALL42,1336,12/21/21
3007,0,2,2,4,AMMO01,1339,12/21/21
3008,0,2,4,6,BALL27,1342,12/21/21
3009,4,2,3,9,GIZMO91,1348,12/21/21
3010,2,2,3,7,GIZMO92,1348,12/21/21
3011,3,2,1,6,SMALL55,1403,12/21/21
3012,3,2,2,7,SCARE13,1415,12/21/21
3013,0,3,4,7,DRAGN64,1409,12/21/21
3014,3,2,2,7,DRAGN62,1409,12/21/21
3015,0,2,1,3,DRAGN77,1418,12/21/21
3016,2,2,1,5,SLOW11,1521,12/21/21
3017,2,2,0,4,SLOW12,1524,12/21/21
3018,0,0,2,2,RECON09,1600,12/21/21
3019,1,0,0,1,craze77,1703,12/21/21
3020,1,0,3,4,dragn65,1657,12/21/21
3021,1,0,2,3,dragn65,1706,12/21/21
3022,1,0,1,2,evil02,1709,12/21/21
3023,1,0,1,2,ball88,1700,12/21/21
3024,1,4,4,9,FURY01,745,12/22/21
3025,2,3,6,11,EPIC02,730,12/22/21
3026,2,4,6,12,LOOKER01,739,12/22/21
3027,1,3,4,8,DRAGON41,754,12/22/21
3028,2,3,5,10,FURY04,748,12/22/21
3029,2,3,5,10,EPIC06,733,12/22/21
3030,2,3,7,12,GHOST53,736,12/22/21
3031,1,3,4,8,DRAGN05,757,12/22/21
3032,2,3,7,12,LOADED01,800,12/22/21
3033,4,3,5,12,AMMO14,751,12/22/21
3034,1,4,9,14,HANG51,818,12/22/21
3035,2,3,1,6,RECON89,815,12/22/21
3036,1,3,7,11,STAB12,821,12/22/21
3037,1,3,6,10,STAB11,824,12/22/21
3038,0,3,3,6,BALL88,812,12/22/21
3039,1,3,1,5,PAWS81,803,12/22/21
3040,1,4,4,9,DRAGN,833,12/22/21
3041,0,3,4,7,DRAGN62,833,12/22/21
3042,1,5,1,7,EASY42,802,12/22/21
3043,3,2,5,10,SLOW11,836,12/22/21
3044,2,4,0,6,DRAGN69,830,12/22/21
3045,1,1,3,5,BALL38,851,12/22/21
3046,1,5,4,10,BALL35,848,12/22/21
3047,0,4,1,5,PAWS46,845,12/22/21
3048,1,4,1,6,SCARE76,857,12/22/21
3049,2,4,1,7,SMALL07,909,12/22/21
3050,0,3,2,5,BALL11,906,12/22/21
3051,2,3,5,10,SMALL15,927,12/22/21
3052,1,3,1,5,BALL42,900,12/22/21
3053,2,3,3,8,SPECK48,906,12/22/21
3054,1,3,3,7,PAWS34,851,12/22/21
3055,0,4,1,5,LOOT50,912,12/22/21
3056,1,4,0,5,BALL19,918,12/22/21
3057,1,4,1,6,BALL28,921,12/22/21
3058,0,3,3,6,BALL27,924,12/22/21
3059,1,3,5,9,DRAGN64,936,12/22/21
3060,1,4,0,5,SCARE15,951,12/22/21
3061,2,3,3,8,SHINR81,945,12/22/21
3062,0,1,5,6,HOOK71,939,12/22/21
3063,1,3,0,4,SCARE15,1048,12/22/21
3064,4,4,1,9,SMALL47,1045,12/22/21
3065,2,2,8,12,EPIC06,1118,12/22/21
3066,1,3,3,7,HOOK75,1127,12/22/21
3067,2,2,1,5,CRAZE43,1115,12/22/21
3068,0,2,1,3,BALL82,1133,12/22/21
3069,4,2,2,8,FURY08,1136,12/22/21
3070,2,2,8,12,EPIC02,1130,12/22/21
3071,2,2,1,5,FURY07,1139,12/22/21
3072,2,1,6,9,FURY01,1145,12/22/21
3073,4,2,3,9,CRAZE45,1148,12/22/21
3074,1,2,6,9,DRAGN41,1157,12/22/21
3075,1,2,6,9,DRAGN05,1200,12/22/21
3076,4,3,2,9,DRAGN17,1212,12/22/21
3077,2,3,6,11,AMMO04,1142,12/22/21
3078,3,2,5,10,SCARE13,1203,12/22/21
3079,1,2,3,6,SCARE12,1206,12/22/21
3080,4,3,4,11,DRAGN33,1209,12/22/21
3081,1,4,3,8,EASY42,1149,12/22/21
3082,1,2,8,11,DRAGN32,1218,12/22/21
3083,0,3,2,5,BALL42,1239,12/22/21
3084,0,2,2,4,CRAZE66,1233,12/22/21
3085,2,2,1,5,SMALL16,1230,12/22/21
3086,0,3,4,7,EPIC01,1227,12/22/21
3087,1,0,1,2,WIRE31,1242,12/22/21
3088,1,0,1,2,WIRE32,1242,12/22/21
3089,0,1,5,6,PHNTM69,1254,12/22/21
3090,0,2,4,6,PHNT50,1236,12/22/21
3091,0,1,4,5,BALL28,1257,12/22/21
3092,2,2,2,6,BALL19,1315,12/22/21
3093,3,2,4,9,RECON01,1248,12/22/21
3094,0,3,4,7,SPECK48,1315,12/22/21
3095,1,5,5,11,ETCH41,800,1/5/22
3096,1,5,7,13,ETCH42,800,1/5/22
3097,1,1,3,5,AXLE11,806,1/5/22
3098,1,1,3,5,AXLE12,809,1/5/22
3099,1,2,2,5,CRAZE46,818,1/5/22
3100,0,2,6,8,BALL61,815,1/5/22
3101,2,4,5,11,BALL03,812,1/5/22
3102,1,1,8,10,VEGA21,832,1/5/22
3103,1,1,0,2,VEGA22,833,1/5/22
3104,1,3,5,9,STAB11,827,1/5/22
3105,1,3,4,8,STAB12,830,1/5/22
3106,3,3,7,13,BALL22,839,1/5/22
3107,2,1,7,10,PAWS34,824,1/5/22
3108,0,2,4,6,BALL69,842,1/5/22
3109,0,3,2,5,BALL31,857,1/5/22
3110,0,3,3,6,BALL88,909,1/5/22
3111,2,1,4,7,BALL27,848,1/5/22
3112,0,2,7,9,SPEC48,851,1/5/22
3113,3,3,4,10,BALL57,918,1/5/22
3114,1,1,7,9,HOOK03,921,1/5/22
3115,0,3,4,7,CREEP31,927,1/5/22
3116,0,3,7,10,CREEP32,930,1/5/22
3117,1,3,5,9,SPOT91,912,1/5/22
3118,1,3,4,8,SPOT92,915,1/5/22
3119,0,2,2,4,CRAZE14,906,1/5/22
3120,0,1,5,6,PHNTM03,951,1/5/22
3121,0,1,4,5,DRAGN61,939,1/5/22
3122,0,3,4,7,HOOK25,945,1/5/22
3123,2,0,4,6,CRAZE11,924,1/5/22
3124,3,1,4,8,HOOK22,933,1/5/22
3125,1,3,4,8,AXLE11,954,1/5/22
3126,1,3,2,6,AXLE12,956,1/5/22
3127,1,3,1,5,WIRE31,1000,1/5/22
3128,1,3,2,6,WIRE32,1003,1/5/22
3129,3,4,7,14,LOOKER1,1018,1/5/22
3130,3,4,7,14,LOOKER2,1021,1/5/22
3131,1,2,2,5,LOADED1,1012,1/5/22
3132,1,2,2,5,LOADED2,1015,1/5/22
3133,1,4,6,11,SHINR81,1024,1/5/22
3134,1,4,8,13,SHINR82,1027,1/5/22
3135,0,4,4,8,HOOK16,1112,1/5/22
3136,0,4,2,6,PAWS42,1118,1/5/22
3137,1,4,9,14,RENO71,1121,1/5/22
3138,1,4,10,15,RENO72,1124,1/5/22
3139,2,3,5,10,PHNTM50,1203,1/5/22
3140,0,3,5,8,CRAZE46,1218,1/5/22
3141,0,2,4,6,DAWG02,1206,1/5/22
3142,0,4,4,8,GHOST48,1200,1/5/22
3143,0,5,2,7,BALL38,1212,1/5/22
3144,0,3,8,11,COBRA08,1215,1/5/22
3145,2,3,3,8,EPIC06,1230,1/5/22
3146,0,3,7,10,DAWG07,1209,1/5/22
3147,0,5,8,13,COBRA05,1227,1/5/22
3148,0,3,4,7,CRAZE34,1224,1/5/22
3149,4,3,6,13,RECON03,1236,1/5/22
3150,1,3,1,5,BALL91,1230,1/5/22
3151,1,3,2,6,BALL92,1230,1/5/22
3152,1,1,5,7,EASY85,1235,1/5/22
3153,0,3,3,6,BALL28,1303,1/5/22
3154,3,1,8,12,BALL02,1254,1/5/22
3155,2,3,4,9,PAWS16,1300,1/5/22
3156,2,3,3,8,BALL75,1306,1/5/22
3157,1,3,5,9,VEGA21,1309,1/5/22
3158,1,3,6,10,VEGA22,1312,1/5/22
3159,1,3,1,5,WIRE31,1242,1/5/22
3160,1,3,5,9,WIRE32,1245,1/5/22
3161,1,3,7,11,SPOT91,1315,1/5/22
3162,1,3,1,5,SPOT92,1318,1/5/22
3163,4,3,5,12,DRAGN19,1248,1/5/22
3164,1,3,3,7,DRAGN35,1257,1/5/22
3165,0,4,4,8,BALL18,1321,1/5/22
3166,2,3,1,6,BALL15,1324,1/5/22
3167,1,3,3,7,BALL87,1327,1/5/22
3168,0,5,6,11,GHOST69,1400,1/5/22
3169,2,2,5,9,FURY08,1403,1/5/22
3170,2,2,3,7,DRAGN62,1406,1/5/22
3171,2,3,4,9,DRAGN25,1412,1/5/22
3172,1,3,4,8,DRAGN22,1415,1/5/22
3173,1,3,4,8,AXLE11,1421,1/5/22
3174,1,3,5,9,AXLE12,1424,1/5/22
3175,2,3,3,8,LOADED1,1357,1/5/22
3176,2,3,4,9,LOADED2,1400,1/5/22
3177,0,3,4,7,CRAZE09,1433,1/5/22
3178,2,3,4,9,CRAZY11,1409,1/5/22
3179,0,8,5,13,DRAGN71,809,1/6/22
3180,1,6,0,7,COACH21,845,1/6/22
3181,1,6,4,11,COACH22,848,1/6/22
3182,0,0,0,0,BALL75,903,1/6/22
3183,1,6,4,11,BALL69,857,1/6/22
3184,0,6,0,6,CRAZE25,912,1/6/22
3185,0,8,3,11,BALL18,906,1/6/22
3186,0,5,4,9,BALL88,900,1/6/22
3187,2,6,5,13,FURY08,918,1/6/22
3188,1,7,5,13,HANG51,933,1/6/22
3189,1,7,2,10,HANG52,936,1/6/22
3190,4,6,2,12,PHANTOM48,924,1/6/22
3191,2,8,2,12,FURY01,915,1/6/22
3192,1,7,1,9,WIRE31,939,1/6/22
3193,1,7,0,8,WIRE32,939,1/6/22
3194,1,6,4,11,GHOST69,921,1/6/22
3195,2,8,6,16,HOOK13,945,1/6/22
3196,2,5,5,12,GIZMO21,1045,1/6/22
3197,2,5,3,10,GIZMO22,1048,1/6/22
3198,0,6,6,12,BALL38,1106,1/6/22
3199,0,9,3,12,CRAZE34,1118,1/6/22
3200,0,9,5,14,BALL82,1109,1/6/22
3201,0,9,6,15,COBRA05,1121,1/6/22
3202,0,9,4,13,CRAZE46,1115,1/6/22
3203,1,8,4,13,VEGA21,1124,1/6/22
3204,1,8,2,11,VEGA22,1127,1/6/22
3205,1,9,5,15,DRAGN25,1136,1/6/22
3206,0,4,2,6,CRAZE43,1139,1/6/22
3207,0,9,4,13,DRAGN91,1142,1/6/22
3208,2,8,4,14,DRAGN31,1133,1/6/22
3209,2,6,1,9,DAWG02,1212,1/6/22
3210,3,7,7,17,HOOK75,1200,1/6/22
3211,1,5,7,13,ETCH41,1242,1/6/22
3212,1,5,4,10,ETCH42,1242,1/6/22
3213,1,5,5,11,HOOK01,1224,1/6/22
3214,2,9,4,15,HOOK68,1218,1/6/22
3215,0,6,4,10,DRAGN67,1236,1/6/22
3216,2,5,4,11,DRAGN33,1218,1/6/22
3217,2,2,3,7,HOOK16,1221,1/6/22
3218,0,8,4,12,HOOK05,1233,1/6/22
3219,0,6,5,11,BALL02,1215,1/6/22
3220,0,9,4,13,DRAGN06,1230,1/6/22
3221,0,4,2,6,DRAGN65,1239,1/6/22
3222,0,6,2,8,PAWS09,1236,1/6/22
3223,1,5,5,11,COACH21,1248,1/6/22
3224,1,5,4,10,COACH22,1248,1/6/22
3225,4,6,2,12,PAWS16,1245,1/6/22
3226,0,6,3,9,BALL11,1300,1/6/22
3227,1,6,5,12,WIRE31,1254,1/6/22
3228,1,6,1,8,WIRE32,1254,1/6/22
3229,1,8,4,13,FURY01,1309,1/6/22
3230,0,6,3,9,BALL89,1303,1/6/22
3231,0,8,3,11,BALL21,1500,1/6/22
3232,0,3,3,6,BALL88,1306,1/6/22
3233,2,8,5,15,FURY08,1312,1/6/22
3234,2,5,6,13,GHOST69,1315,1/6/22
3235,4,3,5,12,PHNTM48,1318,1/6/22
3236,1,3,3,7,PHNTM50,1400,1/6/22
3237,2,6,1,9,EPIC06,1406,1/6/22
3238,4,4,1,9,RECON03,1409,1/6/22
3239,1,3,2,6,GHOST48,1403,1/6/22
3240,0,2,0,2,CRAZE14,1412,1/6/22
3241,2,3,1,6,CRAZE43,1415,1/6/22
3242,5,5,5,15,HANG51,1418,1/6/22
3243,5,5,1,11,HANG52,1418,1/6/22
3244,1,6,2,9,HOOK45,1427,1/6/22
3245,2,2,7,11,DRAGN71,1430,1/6/22
3246,2,6,3,11,HOOK03,1430,1/6/22
3247,3,3,2,8,DRAGN35,1433,1/6/22
3248,4,7,6,17,PHNTM51,1424,1/6/22
3249,0,5,4,9,CRAZE33,1436,1/6/22
3250,0,3,8,11,CRAZE46,7330,1/7/22
3251,1,3,7,11,DRAGN29,7360,1/7/22
3252,4,3,3,10,DRAGN22,745,1/7/22
3253,1,3,6,10,DRAGN86,739,1/7/22
3254,4,3,6,13,DRAGN25,742,1/7/22
3255,0,3,7,10,DRAGN71,754,1/7/22
3256,0,3,7,10,DRAGN31,751,1/7/22
3257,1,3,4,8,EVIL02,748,1/7/22
3258,1,3,3,7,ETCH41,803,1/7/22
3259,1,3,7,11,ETCH41,803,1/7/22
3260,1,3,6,10,SHINR81,757,1/7/22
3261,2,3,5,10,SHINR82,7570,1/7/22
3262,0,3,7,10,DRAGN64,809,1/7/22
3263,1,3,4,8,PAWS16,812,1/7/22
3264,1,3,4,8,BALL88,815,1/7/22
3265,2,3,0,5,RHINO99,730,1/7/22
3266,2,1,5,8,BALL 05,818,1/7/22
3267,1,3,3,7,DRAGN 91,845,1/7/22
3268,1,1,3,5,DRAGN 02,848,1/7/22
3269,1,2,4,7,CRAZE 54,851,1/7/22
3270,1,1,2,4,DRAGN 12,836,1/7/22
3271,2,3,3,8,RECON 69,854,1/7/22
3272,0,3,2,5,BALL 09,903,1/7/22
3273,0,3,1,4,BALL 11,839,1/7/22
3274,2,3,2,7,SMALL 04,900,1/7/22
3275,0,4,1,5,FURY 01,909,1/7/22
3276,0,3,1,4,PAWS 76,906,1/7/22
3277,1,1,1,3,CRAZE 45,918,1/7/22
3278,2,2,0,4,PHNTM48,915,1/7/22
3279,1,3,5,9,GHOST 69,912,1/7/22
3280,2,3,4,9,FURY 04,921,1/7/22
3281,1,2,2,5,EPIC 06,930,1/7/22
3282,1,2,2,5,DRAGN 59,939,1/7/22
3283,2,1,3,6,CRAZE43,933,1/7/22
3284,2,3,6,11,EPIC 01,924,1/7/22
3285,1,4,3,8,HANG 51,942,1/7/22
3286,1,4,2,7,HANG 52,945,1/7/22
3287,2,1,2,5,EPIC 02,927,1/7/22
3288,1,4,1,6,STAB 11,1033,1/7/22
3289,1,4,2,7,STAB 12,1036,1/7/22
3290,0,3,1,4,CRAZE 09,1039,1/7/22
3291,1,3,3,7,HOOK45,1042,1/7/22
3292,1,5,2,8,BALL 89,1106,1/7/22
3293,2,3,2,7,BALL 42,1030,1/7/22
3294,1,4,2,7,SCARE 73,1103,1/7/22
3295,1,1,7,9,VEGA 21,1109,1/7/22
3296,1,1,2,4,VEGA 22,1112,1/7/22
3297,3,1,2,6,CRAZE 33,1145,1/7/22
3298,0,4,6,10,DRAGN67,1157,1/7/22
3299,0,3,4,7,DRAGN 61,1200,1/7/22
3300,1,4,5,10,SHINR 81,1151,1/7/22
3301,1,4,7,12,SHINR 82,1154,1/7/22
3302,0,4,7,11,DRAGN 64,1206,1/7/22
3303,3,3,3,9,DRAGN 38,1148,1/7/22
3304,1,3,2,6,BALL 88,1212,1/7/22
3305,2,4,3,9,DRAGN 13,1203,1/7/22
3306,2,3,1,6,BALL 02,1215,1/7/22
3307,0,3,4,7,SPECK 48,1218,1/7/22
3308,0,3,1,4,DRAGN 96,1221,1/7/22
3309,1,3,4,8,CREEP 31,1242,1/7/22
3310,1,3,3,7,CREEP 32,1245,1/7/22
3311,1,3,4,8,EASY85,1300,1/7/22
3312,1,2,3,6,AMMO09,1333,1/7/22
3313,1,3,4,8,TORA12,948,1/7/22
3314,1,3,3,7,TORA11,951,1/7/22
3315,1,3,3,7,AXLE11,1339,1/7/22
3316,3,4,3,10,RECON01,1336,1/7/22
3317,2,3,0,5,BALL14,1345,1/7/22
3318,2,3,4,9,BALL64,1348,1/7/22
3319,2,4,2,8,RECON89,1351,1/7/22
3320,2,3,3,8,EPIC06,1403,1/7/22
3321,4,2,0,6,RECON03,1406,1/7/22
3322,2,3,3,8,EPIC02,1354,1/7/22
3323,4,3,2,9,HOOK59,1400,1/7/22
3324,4,4,5,13,PHNTM51,1409,1/7/22
3325,2,3,1,6,HOOK16,1227,1/7/22
3326,3,3,2,8,FILL31,1233,1/7/22
3327,3,3,2,8,FILL32,1236,1/7/22
3328,2,5,1,8,HOOK33,1230,1/7/22
3329,2,2,4,8,DRAGON55,1412,1/7/22
3330,2,4,2,8,SMALL61,1415,1/7/22
3331,2,4,0,6,HOOK35,1239,1/7/22
3332,0,3,2,5,HOOK05,1445,1/7/22
3333,2,4,3,9,PHNTM99,1448,1/7/22
3334,2,4,1,7,DRAGN45,1451,1/7/22
3335,1,3,0,4,BALL75,827,1/7/22
3336,1,3,4,8,HOOK62,1506,1/7/22
3337,0,3,0,3,BALL29,830,1/7/22
3338,0,3,1,4,HOOK68,1503,1/7/22
3339,1,3,0,4,BALL25,824,1/7/22
3340,1,2,0,3,WIRE31,1457,1/7/22
3341,1,2,0,3,WIRE32,1457,1/7/22
3342,,3,1,,HOOK67,1454,1/7/22
3343,2,3,1,6,HOOK03,1509,1/7/22
3344,0,3,1,4,ball 38,1512,1/7/22
3345,2,4,1,7,ball 31,1521,1/7/22
3346,4,4,0,8,paws 25,1630,1/7/22
3347,3,2,3,8,phntm 50,1600,1/7/22
3348,0,3,3,6,PHNTM69,806,1/10/22
3349,1,1,6,8,coach21,800,1/10/22
3350,2,1,9,12,coach22,800,1/10/22
3351,2,3,6,11,WIRE31,812,1/10/22
3352,2,3,1,6,WIRE32,812,1/10/22
3353,0,1,2,3,PAWS16,809,1/10/22
3354,0,0,0,0,BALL19,818,1/10/22
3355,4,3,3,10,DRAGN71,821,1/10/22
3356,4,3,4,11,STAB11,833,1/10/22
3357,2,3,7,12,STAB12,836,1/10/22
3358,2,1,6,9,DRAGN64,839,1/10/22
3359,1,1,2,4,CRAZE45,900,1/10/22
3360,2,3,4,9,FURY01,857,1/10/22
3361,0,2,0,2,FURY07,903,1/10/22
3362,3,1,3,7,RECON03,909,1/10/22
3363,1,3,1,5,EPIC06,918,1/10/22
3364,2,3,5,10,EPIC01,912,1/10/22
3365,2,3,2,7,EPIC02,915,1/10/22
3366,2,4,3,9,CRAZE43,921,1/10/22
3367,0,5,0,5,CRAZE09,939,1/10/22
3368,1,3,0,4,PHNTM48,924,1/10/22
3369,0,3,2,5,DRAGN59,936,1/10/22
3370,1,1,2,4,HANG51,927,1/10/22
3371,1,1,2,4,HANG52,927,1/10/22
3372,1,3,2,6,PHNTM99,942,1/10/22
3373,3,5,0,8,SCARE12,945,1/10/22
3374,1,4,2,7,PHNTM51,933,1/10/22
3375,1,1,2,4,GIZMO11,948,1/10/22
3376,1,1,5,7,GIZMO12,951,1/10/22
3377,1,4,1,6,DRAGN05,1012,1/10/22
3378,0,1,5,6,HOOK38,1003,1/10/22
3379,0,3,4,7,PAWS42,1015,1/10/22
3380,1,2,6,9,HOOK72,1023,1/10/22
3381,2,2,0,4,BALL88,957,1/10/22
3382,2,3,3,8,HOOK55,1018,1/10/22
3383,0,1,1,2,BALL42,954,1/10/22
3384,2,3,3,8,HOOK32,1006,1/10/22
3385,2,3,3,8,SHINR81,1106,1/10/22
3386,1,3,1,5,SHINR82,1109,1/10/22
3387,2,3,0,5,SMALL60,1112,1/10/22
3388,1,3,3,7,EVIL02,1103,1/10/22
3389,1,5,0,6,POST61,1124,1/10/22
3390,1,5,3,9,POST62,1127,1/10/22
3391,2,3,1,6,DRAGN24,1115,1/10/22
3392,1,1,3,5,BALL38,1133,1/10/22
3393,0,3,0,3,CRAZE34,1139,1/10/22
3394,0,3,1,4,DRAGN86,1118,1/10/22
3395,0,3,3,6,COBRA01,1130,1/10/22
3396,0,1,5,6,RECON01,1136,1/10/22
3397,1,4,3,8,DRAGN21,1121,1/10/22
3398,1,5,4,10,BALL82,1145,1/10/22
3399,2,3,4,9,PAWS54,1151,1/10/22
3400,0,3,2,5,RECON71,1142,1/10/22
3401,1,2,3,6,STAB11,1154,1/10/22
3402,1,2,3,6,STAB12,1157,1/10/22
3403,0,3,4,7,BALL18,1203,1/10/22
3404,1,3,4,8,BALL11,1200,1/10/22
3405,2,3,3,8,DRAGN02,1209,1/10/22
3406,0,4,8,12,PHNTM45,1212,1/10/22
3407,0,1,8,9,HOOK62,1227,1/10/22
3408,1,3,6,10,WIRE31,1227,1/10/22
3409,3,3,6,12,WIRE32,1230,1/10/22
3410,2,3,7,12,DRAGN76,1215,1/10/22
3411,2,3,3,8,FURY01,1233,1/10/22
3412,0,3,3,6,CRAZE22,1218,1/10/22
3413,2,2,2,6,DRAGN65,1224,1/10/22
3414,0,1,1,2,CRAZE43,1206,1/10/22
3415,0,3,8,11,GHOST53,1245,1/10/22
3416,2,3,1,6,CRAZE61,1242,1/10/22
3417,3,3,4,10,BALL64,1236,1/10/22
3418,2,3,1,6,BALL02,1239,1/10/22
3419,0,3,5,8,RECON89,1400,1/10/22
3420,1,3,3,7,EPIC06,1412,1/10/22
3421,1,5,3,9,GHOST69,1403,1/10/22
3422,2,3,1,6,RECON01,1406,1/10/22
3423,2,3,1,6,EPIC02,1409,1/10/22
3424,3,2,2,7,DRAGN45,1430,1/10/22
3425,0,5,4,9,PHNTM45,1424,1/10/22
3426,1,3,2,6,DRAGN51,1421,1/10/22
3427,3,3,8,14,EPIC01,1418,1/10/22
3428,0,5,2,7,PHNTM03,1436,1/10/22
3429,0,2,3,5,LOOT99,1433,1/10/22
3430,0,2,2,4,DRAGN17,1427,1/10/22
3431,1,2,3,6,EASY01,1445,1/10/22
3432,1,0,2,3,EASY02,1448,1/10/22
3433,2,3,3,8,DRAGN31,1442,1/10/22
3434,2,3,4,9,DRAGN19,1439,1/10/22
3435,1,3,2,6,HANG51,1457,1/10/22
3436,1,3,4,8,HANG52,1500,1/10/22
3437,0,1,5,6,HOOK83,1454,1/10/22
3438,1,1,3,5,DRAGN96,1503,1/10/22
3439,0,3,6,9,COBRA05,1512,1/10/22
3440,1,4,4,9,BALL38,1506,1/10/22
3441,2,2,1,5,RECON09,1521,1/10/22
3442,2,3,3,8,GHOST48,1524,1/10/22
3443,2,2,2,6,DRAGN05,1612,1/10/22
3444,4,2,4,10,DRAGN44,1609,1/10/22
3445,2,2,1,5,BALL89,1739,1/10/22
3446,0,0,5,5,BALL11,800,1/11/22
3447,0,1,5,6,BALL18,803,1/11/22
3448,1,3,8,12,STAB11/12,818,1/11/22
3449,0,1,2,3,DRAGN71,809,1/11/22
3450,4,4,2,10,DRAGN61,812,1/11/22
3451,2,3,6,11,DRAGN66,815,1/11/22
3452,2,1,2,5,DRAGN67,824,1/11/22
3453,2,1,0,3,RAPPA,806,1/11/22
3454,1,3,3,7,GHOST,833,1/11/22
3455,2,3,2,7,BALL67,836,1/11/22
3456,2,3,3,8,CRAZE61,830,1/11/22
3457,3,1,4,8,FURY04,839,1/11/22
3458,2,2,1,5,FURY01,827,1/11/22
3459,2,3,5,10,EPIC01,842,1/11/22
3460,1,4,3,8,EPIC06,845,1/11/22
3461,3,3,2,8,PHNTM48,848,1/11/22
3462,0,3,3,6,RECON88,909,1/11/22
3463,0,2,2,4,RECON81,912,1/11/22
3464,1,5,6,12,DRAGN55,857,1/11/22
3465,3,5,1,9,SMALL005,903,1/11/22
3466,1,3,4,8,DRAGN45,921,1/11/22
3467,0,3,3,6,DRAGN05,918,1/11/22
3468,0,0,0,0,BALL42,1006,1/11/22
3469,0,3,0,3,BALL42,1006,1/11/22
3470,1,3,1,5,CRAZE09,924,1/11/22
3471,1,2,4,7,DRAGN44,927,1/11/22
3472,2,6,4,12,SHINER81/82,933,1/11/22
3473,0,4,3,7,BALL09,930,1/11/22
3474,1,2,6,9,DRAGN12,942,1/11/22
3475,3,6,2,11,VEGA21,945,1/11/22
3476,1,3,1,5,DRAGN35,939,1/11/22
3477,4,6,8,18,GIZMO31/2,954,1/11/22
3478,0,4,0,4,PAWS16,1000,1/11/22
3479,0,3,0,3,BALL25,1003,1/11/22
3480,0,3,3,6,BALL63,1007,1/11/22
3481,0,3,4,7,HOOK29,951,1/11/22
3482,4,0,4,8,LOADED1/2,1015,1/11/22
3483,2,8,3,13,LOOKER1/2,1021,1/11/22
3484,2,6,7,15,GIZMO71/2,1027,1/11/22
3485,1,2,4,7,COBRA01,1103,1/11/22
3486,0,2,4,6,BALL05,1100,1/11/22
3487,0,5,1,6,BALL35,1112,1/11/22
3488,0,3,1,4,CRAZE34,1109,1/11/22
3489,4,3,2,9,SMALL06,1118,1/11/22
3490,1,3,3,7,SCARE99,1115,1/11/22
3491,2,6,4,12,STAB11/12,1133,1/11/22
3492,4,3,3,10,BALL11,1139,1/11/22
3493,0,3,5,8,PAWS25,1145,1/11/22
3494,2,2,6,10,DRAGN62,1206,1/11/22
3495,2,2,6,10,BALL18,1148,1/11/22
3496,1,3,0,4,PAWS76,1148,1/11/22
3497,2,3,3,8,BALL15,1142,1/11/22
3498,6,4,11,21,WIRE31/32,1157,1/11/22
3499,2,3,2,7,DRAGN65,1203,1/11/22
3500,1,3,1,5,FURY01,1209,1/11/22
3501,1,3,4,8,FURY07,1212,1/11/22
3502,2,4,2,8,SPECK48,1012,1/11/22
3503,3,2,4,9,DRAGN71,1154,1/11/22
3504,2,3,5,10,FURY04,1218,1/11/22
3505,1,2,0,3,CRAZE61,1221,1/11/22
3506,1,3,3,7,EPIC06,1233,1/11/22
3507,2,2,3,7,EPIC02,1227,1/11/22
3508,2,3,2,7,CRAZE42,1236,1/11/22
3509,2,2,4,8,CRAZE43,1224,1/11/22
3510,2,2,3,7,CRAZE14,1239,1/11/22
3511,3,4,1,8,SMALL23,1245,1/11/22
3512,0,3,4,7,DRAGN54,1242,1/11/22
3513,2,2,0,4,BALL89,1248,1/11/22
3514,2,4,3,9,CRAZE66,1251,1/11/22
3515,3,2,2,7,SCARE19,1409,1/11/22
3516,0,3,1,4,BALL79,1400,1/11/22
3517,1,2,1,4,DRAGN06,1406,1/11/22
3518,2,3,1,6,SHINER81,1418,1/11/22
3519,1,3,0,4,SHINER82,1421,1/11/22
3520,2,2,2,6,CRAZE69,1412,1/11/22
3521,3,3,3,9,DRAGN13,1430,1/11/22
3522,2,1,2,5,HOOK44,1403,1/11/22
3523,1,3,1,5,BALL38,1436,1/11/22
3524,0,4,3,7,BALL05,1439,1/11/22
3525,0,3,2,5,BALL35,1445,1/11/22
3526,1,3,2,6,BALL82,1442,1/11/22
3527,4,3,3,10,RECON03,1448,1/11/22
3528,2,4,2,8,BALL89,1742,1/11/22
3529,1,3,4,8,WIRE,800,1/12/22
3530,2,2,8,12,PAWS25,806,1/12/22
3531,0,3,5,8,CRAZE76,809,1/12/22
3532,2,3,6,11,DRAGN72,818,1/12/22
3533,0,3,2,5,BALL71,815,1/12/22
3534,2,3,5,10,PHNTM45,827,1/12/22
3535,1,3,4,8,BALL18,812,1/12/22
3536,2,3,6,11,DRAGN62,830,1/12/22
3537,1,3,6,10,DRAGN66,827,1/12/22
3538,4,4,2,10,DRAGN61,833,1/12/22
3539,1,3,1,5,CRAZE45,842,1/12/22
3540,1,3,1,5,CRAZE61,836,1/12/22
3541,3,3,7,13,EPIC01,851,1/12/22
3542,1,3,1,5,RECON03,845,1/12/22
3543,2,3,3,8,FURY07,848,1/12/22
3544,0,3,3,6,BALL56,903,1/12/22
3545,3,2,2,7,PHNTM48,854,1/12/22
3546,1,3,5,9,EPIC05,900,1/12/22
3547,1,3,1,5,CRAZE43,857,1/12/22
3548,0,2,1,3,DRAGN45,924,1/12/22
3549,1,2,1,4,BALL88,906,1/12/22
3550,1,3,4,8,DRAGN51,912,1/12/22
3551,1,3,7,11,DRAGN55,915,1/12/22
3552,0,3,2,5,DRAGN05,918,1/12/22
3553,1,3,3,7,DRAGN44,921,1/12/22
3554,0,3,3,6,CRAZE22,927,1/12/22
3555,2,3,2,7,SHINR81,933,1/12/22
3556,1,3,4,8,VEGA21,842,1/12/22
3557,2,3,1,6,LOADED1,1000,1/12/22
3558,0,3,1,4,BALL75,948,1/12/22
3559,1,2,0,3,HOOK32,939,1/12/22
3560,0,3,2,5,HOOK75,1015,1/12/22
3561,0,4,1,5,BALL79,954,1/12/22
3562,0,2,1,3,BALL42,951,1/12/22
3563,2,2,6,10,HANG51,1106,1/12/22
3564,1,2,3,6,BALL35,1112,1/12/22
3565,2,2,4,8,DRAGN83,1109,1/12/22
3566,2,3,4,9,DRAGN31,1115,1/12/22
3567,0,2,4,6,DRAGN23,1106,1/12/22
3568,3,2,1,6,RENO71,1135,1/12/22
3569,1,2,4,7,WIRE31,1148,1/12/22
3570,0,2,0,2,BALL29,1142,1/12/22
3571,4,2,1,7,DRAGN16,1157,1/12/22
3572,0,2,3,5,HOOK33,1139,1/12/22
3573,2,2,3,7,AMMO05,1154,1/12/22
3574,2,2,7,11,DRAGN62,1203,1/12/22
3575,3,2,7,12,DRAGN66,1206,1/12/22
3576,3,2,5,10,STAB11,1209,1/12/22
3577,2,2,8,12,DRAGN72,1200,1/12/22
3578,1,3,2,6,CRAZE61,1218,1/12/22
3579,3,3,2,8,GHOST69,1215,1/12/22
3580,2,2,2,6,BALL02,1221,1/12/22
3581,1,2,0,3,SCARE99,1224,1/12/22
3582,0,2,2,4,RECON88,1233,1/12/22
3583,1,2,2,5,CRAZE14,1227,1/12/22
3584,2,3,4,9,GHOST53,1230,1/12/22
3585,0,2,3,5,CRAZE55,1236,1/12/22
3586,2,2,5,9,CRAE43,1400,1/12/22
3587,1,2,6,9,EPIC06,1406,1/12/22
3588,2,2,5,9,SMALL57,1409,1/12/22
3589,1,2,3,6,EPIC02,1403,1/12/22
3590,1,2,7,10,DRAGN55,1412,1/12/22
3591,2,1,2,5,Dragn05,1512,1/12/22
3592,0,1,4,5,DRAGN44,1421,1/12/22
3593,0,2,4,6,DRAGN37,1436,1/12/22
3594,1,2,5,8,DRAGN06,1424,1/12/22
3595,0,3,4,7,PHNTM51,1418,1/12/22
3596,2,2,2,6,SMALL70,1436,1/12/22
3597,1,2,3,6,HANG51,1442,1/12/22
3598,0,2,5,7,COBRA05,1451,1/12/22
3599,0,3,6,9,COBRA08,1442,1/12/22
3600,1,3,5,9,HOOK17,1500,1/12/22
3601,2,2,5,9,RECON71,1506,1/12/22
3602,1,2,6,9,COBRA01,1454,1/12/22
3603,0,2,1,3,SPECK48,1509,1/12/22
3604,1,2,2,5,TORA21,1500,1/12/22
3605,1,2,6,9,SCARE77,957,1/13/22
3606,1,4,4,9,RENO71,806,1/13/22
3607,1,4,2,7,RENO72,807,1/13/22
3608,2,3,2,7,BALL01,803,1/13/22
3609,1,3,1,5,EASY11,801,1/13/22
3610,3,4,3,10,BALL18,818,1/13/22
3611,1,4,4,9,ETCH41,827,1/13/22
3612,1,4,5,10,ETCH42,827,1/13/22
3613,2,5,4,11,DRAGN72,824,1/13/22
3614,4,3,2,9,BALL02,815,1/13/22
3615,1,3,3,7,DRAGN65,833,1/13/22
3616,1,3,2,6,DRAGN67,836,1/13/22
3617,4,2,2,8,DRAGN61,839,1/13/22
3618,1,4,3,8,GHOST69,845,1/13/22
3619,3,4,2,9,RECON93,733,1/13/22
3620,0,4,7,11,RECON81,854,1/13/22
3621,2,5,2,9,RECON88,857,1/13/22
3622,1,3,2,6,SCARE76,900,1/13/22
3623,1,3,0,4,WIRE31,903,1/13/22
3624,1,3,1,5,WIRE32,903,1/13/22
3625,2,3,6,11,EPIC06,915,1/13/22
3626,1,3,5,9,GHOST53,909,1/13/22
3627,0,3,4,7,DRAGN81,921,1/13/22
3628,1,2,1,4,CRAZE43,912,1/13/22
3629,1,2,3,6,CRAZE22,933,1/13/22
3630,0,4,4,8,HOOK51,924,1/13/22
3631,4,2,2,8,DRAGN05,930,1/13/22
3632,0,5,3,8,CRAZE14,851,1/13/22
3633,2,3,6,11,DRAGN62,939,1/13/22
3634,0,8,3,11,DRAGN55,927,1/13/22
3635,2,2,2,6,DRAGN33,936,1/13/22
3636,3,5,9,17,SHINR81,942,1/13/22
3637,1,5,0,6,SHINR82,942,1/13/22
3638,0,2,1,3,LOST11,954,1/13/22
3639,1,4,1,6,LOST12,957,1/13/22
3640,2,4,3,9,GIZMO31,948,1/13/22
3641,2,4,2,8,GIZMO32,951,1/13/22
3642,2,5,4,11,TORA11,1009,1/13/22
3643,2,5,5,12,TORA12,1012,1/13/22
3644,0,3,2,5,HOOK44,1021,1/13/22
3645,1,6,3,10,LOADED1,1015,1/13/22
3646,1,6,7,14,LOADED2,1018,1/13/22
3647,2,3,5,10,LOOKR1,1030,1/13/22
3648,2,3,3,8,LOOKR2,1033,1/13/22
3649,1,2,2,5,EASY11,1031,1/13/22
3650,0,3,5,8,BALL63,1000,1/13/22
3651,3,3,0,6,BALL42,1003,1/13/22
3652,2,3,2,7,SPECK48,1030,1/13/22
3653,2,4,2,8,DRAGN02,1100,1/13/22
3654,1,5,4,10,AXLE11,1109,1/13/22
3655,1,5,3,9,AXLE12,1112,1/13/22
3656,2,2,2,6,RENO71,1115,1/13/22
3657,0,5,1,6,dragn24,1106,1/13/22
3658,4,3,5,12,BALL35,1121,1/13/22
3659,1,4,3,8,SCARE79,1130,1/13/22
3660,4,4,0,8,PHNTM48,1148,1/13/22
3661,2,2,4,8,AMMO09,1203,1/13/22
3662,1,3,5,9,CREEP31,1151,1/13/22
3663,1,3,2,6,CREEP32,1151,1/13/22
3664,2,2,5,9,DRAGN72,1206,1/13/22
3665,0,2,1,3,HOOK03,1209,1/13/22
3666,3,2,2,7,DRAGN65,1215,1/13/22
3667,0,3,7,10,BALL02,1200,1/13/22
3668,3,3,4,10,DRAGN64,1221,1/13/22
3669,1,5,2,8,CRAZE45,1230,1/13/22
3670,1,5,3,9,GHOST69,1227,1/13/22
3671,1,2,2,5,FURY07,1233,1/13/22
3672,1,3,2,6,EPIC02,1239,1/13/22
3673,2,5,0,7,BALL89,1242,1/13/22
3674,1,2,7,10,EPIC06,1236,1/13/22
3675,2,2,1,5,BALL29,1245,1/13/22
3676,1,2,2,5,CRAZE22,1436,1/13/22
3677,2,0,6,8,TAUNT01,1400,1/13/22
3678,2,3,4,9,CRAZE43,1415,1/13/22
3679,1,0,6,7,EPIC05,1412,1/13/22
3680,1,2,1,4,RECON99,1418,1/13/22
3681,0,4,6,10,HOOK37,1439,1/13/22
3682,1,4,8,13,DRAGN33,1427,1/13/22
3683,2,3,3,8,SMALL64,1424,1/13/22
3684,2,3,6,11,BALL77,1500,1/13/22
3685,0,3,3,6,HOOK76,1418,1/13/22
3686,0,3,6,9,BALL35,1503,1/13/22
3687,1,0,6,7,AXLE11,1506,1/13/22
3688,1,0,5,6,AXLE12,1506,1/13/22
3689,0,2,3,5,RECON81,1527,1/13/22
3690,0,2,1,3,CRAZE41,1512,1/13/22
3691,4,5,4,13,PHNTM48,1518,1/13/22
3692,0,6,1,7,Ball 75,809,1/14/22
3693,0,4,3,7,Ball 21,812,1/14/22
3694,2,3,3,8,Ball 15,821,1/14/22
3695,0,3,2,5,Hook 77,824,1/14/22
3696,4,4,3,11,Ball 02,818,1/14/22
3697,5,2,2,9,Dragon 67,836,1/14/22
3698,1,3,5,9,Fury 03,852,1/14/22
3699,3,4,4,11,Dragon 64,830,1/14/22
3700,2,3,3,8,Rhino 99,800,1/14/22
3701,3,6,3,12,Phntm45,833,1/14/22
3702,3,5,4,12,Fury 07,845,1/14/22
3703,1,6,3,10,Taunt 31,848,1/14/22
3704,1,6,1,8,Taunt 32,851,1/14/22
3705,1,2,4,7,Epic 05,854,1/14/22
3706,1,5,2,8,Ball 05,909,1/14/22
3707,1,3,6,10,Epic 06,900,1/14/22
3708,1,7,4,12,Ghost 53,857,1/14/22
3709,1,3,2,6,Epic 02,903,1/14/22
3710,1,1,3,5,Craze 14,906,1/14/22
3711,2,3,1,6,Dragon 86,915,1/14/22
3712,1,5,0,6,Recon 01,912,1/14/22
3713,1,1,5,7,Dragon 05,918,1/14/22
3714,0,7,3,10,Dragon 55,927,1/14/22
3715,1,6,3,10,Scare 26,930,1/14/22
3716,0,2,0,2,Dragon 01,921,1/14/22
3717,0,4,2,6,Craze 22,942,1/14/22
3718,1,3,3,7,Dragn13,933,1/14/22
3719,0,5,5,10,Hook 42,924,1/14/22
3720,1,4,2,7,Dragon 44,939,1/14/22
3721,1,5,4,10,Phntm 51,936,1/14/22
3722,1,6,1,8,Shinr 81,951,1/14/22
3723,1,6,3,10,Shinr 82,951,1/14/22
3724,1,7,1,9,Scare 17,948,1/14/22
3725,1,7,0,8,Dragon 06,945,1/14/22
3726,1,4,7,12,Loaded 1,1015,1/14/22
3727,1,4,3,8,Loaded 2,1018,1/14/22
3728,1,7,1,9,Scare 71,1000,1/14/22
3729,1,7,3,11,Scare 76,1003,1/14/22
3730,1,5,0,6,Ball 42,1006,1/14/22
3731,2,5,1,8,Gizmo 11,1009,1/14/22
3732,2,5,1,8,Gizmo 22,1012,1/14/22
3733,1,5,6,12,Hook 32,1021,1/14/22
3734,2,5,5,12,Tora 11,1027,1/14/22
3735,2,5,5,12,Tora 12,1030,1/14/22
3736,2,7,3,12,Post 61,1103,1/14/22
3737,2,7,3,12,Post 62,1106,1/14/22
3738,2,7,3,12,Dragon 29,1109,1/14/22
3739,1,4,0,5,RENO71,1112,1/14/22
3740,1,4,0,5,Reno72,1115,1/14/22
3741,1,5,5,11,COBRA01,1118,1/14/22
3742,1,7,3,11,BALL38,1124,1/14/22
3743,0,5,1,6,LOOT50,1127,1/14/22
3744,1,5,3,9,VEGA21,1130,1/14/22
3745,2,5,3,10,Vega21,1133,1/14/22
3746,1,2,2,5,EASY11,1201,1/14/22
3747,1,4,2,7,STAB11,1203,1/14/22
3748,3,4,2,9,STAB12,1203,1/14/22
3749,1,2,2,5,BALL08,1154,1/14/22
3750,0,4,2,6,DRAGN03,1215,1/14/22
3751,1,4,2,7,SCARE75,1212,1/14/22
3752,1,2,7,10,TAUNT21,1221,1/14/22
3753,1,2,4,7,TAUNT22,1224,1/14/22
3754,3,2,3,8,DRAGN51,1218,1/14/22
3755,0,3,3,6,DRAGN67,1227,1/14/22
3756,1,3,5,9,FURY03,1230,1/14/22
3757,1,5,1,7,BALL02,1239,1/14/22
3758,3,6,5,14,FURY04,1236,1/14/22
3759,1,7,1,9,RECON99,1254,1/14/22
3760,0,2,4,6,BALL67,1233,1/14/22
3761,2,5,4,11,LOOT08,1242,1/14/22
3762,1,6,3,10,GHOST53,1245,1/14/22
3763,1,7,2,10,EPIC02,1251,1/14/22
3764,1,2,2,5,COACH21,1303,1/14/22
3765,3,2,2,7,COACH22,1306,1/14/22
3766,1,6,6,13,DRAGN51,1257,1/14/22
3767,1,6,8,15,DRAGN51,1300,1/14/22
3768,2,2,2,6,DRAGN05,1418,1/14/22
3769,0,4,3,7,DRAGN44,1412,1/14/22
3770,1,4,1,6,DRAGN06,1421,1/14/22
3771,1,6,2,9,ETCH41,1424,1/14/22
3772,3,6,1,10,ETCH41,1427,1/14/22
3773,2,6,2,10,SMALL70,1436,1/14/22
3774,3,4,2,9,DRAGN76,1433,1/14/22
3775,0,6,7,13,COBRA05,1442,1/14/22
3776,1,5,6,12,WIRE31,1454,1/14/22
3777,1,5,5,11,WIRE31,1454,1/14/22
3778,3,7,1,11,scare71,1515,1/14/22
3779,1,3,0,4,ball19,1500,1/14/22
3780,3,3,2,8,gizmo31,1503,1/14/22
3781,3,3,1,7,GIZMO32,1506,1/14/22
3782,0,1,4,5,CRAZE77,1406,1/14/22
3783,3,3,3,9,CRAZE45,806,1/18/22
3784,1,4,4,9,FURY03,803,1/18/22
3785,1,4,2,7,GHOST53,809,1/18/22
3786,1,3,4,8,EPIC06,812,1/18/22
3787,0,3,2,5,CRAZE42,824,1/18/22
3788,2,2,4,8,CRAZE43,815,1/18/22
3789,0,2,4,6,HOOK81,821,1/18/22
3790,2,3,3,8,DRAGN17,833,1/18/22
3791,2,4,2,8,SMALL65,827,1/18/22
3792,1,4,1,6,LOOT55,830,1/18/22
3793,2,4,3,9,HANG51,839,1/18/22
3794,2,4,0,6,HANG52,839,1/18/22
3795,0,3,7,10,DRAGN32,851,1/18/22
3796,0,4,2,6,RECON88,848,1/18/22
3797,2,3,5,10,RECON69,845,1/18/22
3798,1,4,2,7,COACH21,854,1/18/22
3799,1,4,0,5,COACH22,854,1/18/22
3800,0,3,4,7,RECON71,900,1/18/22
3801,1,3,5,9,HOOK55,903,1/18/22
3802,0,3,6,9,RECON77,906,1/18/22
3803,1,3,3,7,DRAGN63,924,1/18/22
3804,1,3,2,6,DRAGN69,930,1/18/22
3805,1,4,1,6,LOADED01,1012,1/18/22
3806,1,4,1,6,LOADED02,1012,1/18/22
3807,0,3,1,4,PAWS76,1018,1/18/22
3808,1,2,5,8,AXLE11,915,1/18/22
3809,1,2,2,5,AXLE21,915,1/18/22
3810,2,4,2,8,SMALL17,936,1/18/22
3811,1,4,0,5,HOOK61,933,1/18/22
3812,2,4,4,10,LOOT45,927,1/18/22
3813,0,1,2,3,DRAGN05,951,1/18/22
3814,1,3,4,8,GIZMO21,942,1/18/22
3815,1,3,2,6,GIZMO22,942,1/18/22
3816,2,2,4,8,HOOK37,1000,1/18/22
3817,2,4,2,8,TORA11,954,1/18/22
3818,2,4,1,7,TORA12,954,1/18/22
3819,0,3,1,4,HOOK03,1009,1/18/22
3820,4,2,1,7,DRAGN72,1106,1/18/22
3821,0,2,5,7,CRAZE22,948,1/18/22
3822,2,2,0,4,DRAGN01,1100,1/18/22
3823,2,2,1,5,DRAGN71,1103,1/18/22
3824,2,2,4,8,DRAGN59,1115,1/18/22
3825,2,2,3,7,DRAGN77,1109,1/18/22
3826,0,2,2,4,HOOK75,1006,1/18/22
3827,1,2,0,3,POST61,1118,1/18/22
3828,1,2,2,5,POST62,1118,1/18/22
3829,0,2,1,3,HOOK13,1124,1/18/22
3830,2,2,3,7,DRAGN38,1127,1/18/22
3831,1,2,2,5,GHOST69,1142,1/18/22
3832,1,2,3,6,FURY03,1139,1/18/22
3833,4,2,0,6,HOOK99,936,1/18/22
3834,1,1,5,7,BALL05,1200,1/18/22
3835,0,1,4,5,DRAGN32,1136,1/18/22
3836,1,2,6,9,EPIC06,1154,1/18/22
3837,1,2,2,5,RECON99,1157,1/18/22
3838,0,3,2,5,BALL21,1145,1/18/22
3839,1,3,6,10,CRAZE42,1206,1/18/22
3840,2,3,0,5,BALL25,1148,1/18/22
3841,1,2,4,7,CRAZE14,1200,1/18/22
3842,1,2,1,4,DRAGN02,1203,1/18/22
3843,0,1,2,3,CRAZE45,1121,1/18/22
3844,2,2,2,6,DRAGN51,1221,1/18/22
3845,0,2,3,5,DRAGN44,1218,1/18/22
3846,0,1,2,3,FURY02,1236,1/18/22
3847,2,2,2,6,BALL27,1230,1/18/22
3848,0,2,4,6,HOOK24,1224,1/18/22
3849,2,2,2,6,BALL01,1233,1/18/22
3850,0,3,6,9,DAWG05,1409,1/18/22
3851,1,2,6,9,WIRE31,1418,1/18/22
3852,1,3,4,8,AXLE11,1424,1/18/22
3853,2,2,2,6,BALL44,1412,1/18/22
3854,1,3,1,5,DRAGN67,1433,1/18/22
3855,1,3,4,8,STAB11,1439,1/18/22
3856,2,1,2,5,CRAZE77,1500,1/18/22
3857,0,3,2,5,BALL11,1506,1/18/22
3858,2,2,3,7,DRAGN76,1451,1/18/22
3859,1,2,3,6,DRAGN72,1454,1/18/22
3860,1,3,5,9,BALL18,1503,1/18/22
3861,1,3,3,7,COACH21,1509,1/18/22
3862,0,1,2,3,DRAGN05,1457,1/18/22
3863,2,2,0,4,BALL02,1515,1/18/22
3864,1,3,0,4,RECON71,1518,1/18/22
3865,1,2,5,8,DRAGN06,1551,1/18/22
3866,2,3,1,6,HOOK44,1800,1/18/22
3867,2,2,2,6,LOOT51,1757,1/18/22
3868,2,2,1,5,HOOK33,1751,1/18/22
3869,1,2,3,6,BALL42,1803,1/18/22
3870,1,1,0,2,LOOT03,1757,1/18/22
3871,1,1,3,5,DAWG04,1812,1/18/22
3872,2,2,3,7,SPECK48,1809,1/18/22
3873,1,9,4,14,FURY03,806,1/19/22
3874,0,8,6,14,HOOK32,800,1/19/22
3875,2,9,3,14,PHNTM48,957,1/19/22
3876,1,8,4,13,EPIC07,1000,1/19/22
3877,1,9,3,13,FURY04,954,1/19/22
3878,0,8,5,13,BALL01,803,1/19/22
3879,1,9,3,13,DRAGN55,827,1/19/22
3880,0,9,3,12,CRAZE22,830,1/19/22
3881,0,9,3,12,DRAGN06,833,1/19/22
3882,1,5,5,11,BALL88,848,1/19/22
3883,2,9,3,14,DRAGN31,900,1/19/22
3884,2,7,3,12,FURY02,906,1/19/22
3885,3,9,4,16,DRAGN13,851,1/19/22
3886,0,9,6,15,COBRA05,912,1/19/22
3887,0,9,5,14,COBRA06,915,1/19/22
3888,2,9,5,16,DRAGN66,918,1/19/22
3889,3,8,3,14,CRAZE77,921,1/19/22
3890,2,9,2,13,AXLE11,903,1/19/22
3891,1,9,1,11,AXLE12,903,1/19/22
3892,1,9,1,11,DRAGN61,924,1/19/22
3893,1,9,1,11,DRAGN72,933,1/19/22
3894,2,9,4,15,DRAGN44,948,1/19/22
3895,1,9,2,12,DRAGN38,954,1/19/22
3896,2,9,4,15,CRAZE44,939,1/19/22
3897,1,9,1,11,RECON71,942,1/19/22
3898,3,9,4,16,SCARE59,1000,1/19/22
3899,0,9,2,11,BALL69,945,1/19/22
3900,1,9,1,11,TORA11,1003,1/19/22
3901,1,9,1,11,TORA12,1006,1/19/22
3902,1,9,5,15,SLOW21,1009,1/19/22
3903,1,9,2,12,SLOW22,1012,1/19/22
3904,1,8,1,10,BALL11,1024,1/19/22
3905,1,8,1,10,COACH21,1015,1/19/22
3906,1,8,0,9,COACH22,1015,1/19/22
3907,0,8,3,11,BALL18,1021,1/19/22
3908,1,9,2,12,PAWS88,957,1/19/22
3909,0,9,0,9,BALL75,1115,1/19/22
3910,1,9,4,14,FURY04,1133,1/19/22
3911,1,9,1,11,CRAZE45,1139,1/19/22
3912,1,9,4,14,FURY03,1136,1/19/22
3913,1,9,2,12,PHNTM48,1142,1/19/22
3914,2,7,3,12,HOOK33,1151,1/19/22
3915,0,6,2,8,HOOK17,1154,1/19/22
3916,1,9,4,14,GHOST69,1200,1/19/22
3917,0,9,3,12,RECON05,1206,1/19/22
3918,1,9,2,12,BALL42,1157,1/19/22
3919,1,7,2,10,CRAZE14,1212,1/19/22
3920,0,9,3,12,DRAGN51,1215,1/19/22
3921,0,9,1,10,HOOK01,1230,1/19/22
3922,2,7,3,12,DRAGN76,1224,1/19/22
3923,1,9,4,14,LOOT03,1227,1/19/22
3924,1,7,0,8,RECON99,1203,1/19/22
3925,0,9,3,12,HOOK24,1236,1/19/22
3926,0,5,1,6,HOOK38,1254,1/19/22
3927,1,9,3,13,SHINR81,1400,1/19/22
3928,1,9,3,13,SHINR82,1403,1/19/22
3929,1,7,2,10,RENO71,1406,1/19/22
3930,1,7,0,8,RENO72,1409,1/19/22
3931,1,9,4,14,SCARE13,1412,1/19/22
3932,0,9,5,14,DAWG04,1421,1/19/22
3933,0,9,4,13,COBRA08,1424,1/19/22
3934,0,9,7,16,COBRA05,1433,1/19/22
3935,2,9,5,16,BALL45,1421,1/19/22
3936,0,9,4,13,DRAGN61,1439,1/19/22
3937,0,5,10,15,DRAGN63,1500,1/19/22
3938,3,9,2,14,DRAGN72,1503,1/19/22
3939,2,9,2,13,HOOK05,1436,1/19/22
3940,0,8,3,11,DRAGN75,1509,1/19/22
3941,1,8,0,9,STAB11,1515,1/19/22
3942,1,8,2,11,STAB12,1518,1/19/22
3943,2,7,5,14,DRAGN32,1512,1/19/22
3944,1,8,3,12,CREEP31,1521,1/19/22
3945,1,8,2,11,CREEP32,1524,1/19/22
3946,0,9,2,11,BALL75,1533,1/19/22
3947,1,9,0,10,VEGA21,1527,1/19/22
3948,1,9,2,12,VEGA22,1530,1/19/22
3949,2,9,3,14,BALL29,1536,1/19/22
3950,3,9,0,12,GIZMO11,1748,1/19/22
3951,3,9,3,15,GIZMO12,1812,1/19/22
3952,2,8,0,10,BALL21,1745,1/19/22
3953,0,3,3,6,Hook69,1803,1/19/22
3954,2,9,2,13,HOOK51,1800,1/19/22
3955,1,6,5,12,FURY 04,830,1/20/22
3956,3,6,5,14,GHOST 69,812,1/20/22
3957,3,4,1,8,SMALL 61,815,1/20/22
3958,0,6,7,13,CRAZE42,833,1/20/22
3959,0,6,6,12,GHOST53,821,1/20/22
3960,1,5,4,10,EPIC 06,824,1/20/22
3961,1,6,1,8,EPIC02,818,1/20/22
3962,2,6,2,10,RECON99,827,1/20/22
3963,0,6,7,13,DRAGN54,830,1/20/22
3964,0,5,3,8,DRAGN06,836,1/20/22
3965,3,6,2,11,CRAZE22,837,1/20/22
3966,1,4,4,9,STAB11,842,1/20/22
3967,3,5,2,10,HANG51,851,1/20/22
3968,0,6,1,7,DRAGN2,848,1/20/22
3969,3,12,11,26,COACH21,857,1/20/22
3970,2,12,3,17,SHINR81,903,1/20/22
3971,2,3,4,9,DRAGN36,909,1/20/22
3972,0,6,3,9,GHOST02,918,1/20/22
3973,2,10,9,21,RENO71,912,1/20/22
3974,2,4,3,9,FURY02,930,1/20/22
3975,0,6,4,10,BAdGR01,933,1/20/22
3976,1,6,0,7,AXLE11,921,1/20/22
3977,1,6,1,8,AXLE12,921,1/20/22
3978,2,5,3,10,DRAGN66,939,1/20/22
3979,1,5,1,7,PHNTM45,936,1/20/22
3980,1,5,0,6,DRAGN67,945,1/20/22
3981,0,5,6,11,DRAGN63,942,1/20/22
3982,1,5,0,6,BALL05,800,1/20/22
3983,1,6,2,9,DRAGN72,948,1/20/22
3984,2,5,0,7,SMALL30,1000,1/20/22
3985,1,5,1,7,ball45,1000,1/20/22
3986,0,6,3,9,DRAGN44,957,1/20/22
3987,2,4,3,9,LOADED1,1006,1/20/22
3988,2,4,1,7,LOADED1,1006,1/20/22
3989,0,6,1,7,PAWS16,1024,1/20/22
3990,1,6,2,9,BALL  25,1027,1/20/22
3991,1,6,1,8,DRAGN76,1036,1/20/22
3992,1,4,0,5,DRAGN03,1030,1/20/22
3993,0,5,1,6,BALL19,1021,1/20/22
3994,1,4,1,6,TORA21,1015,1/20/22
3995,1,4,2,7,TORA21,1015,1/20/22
3996,0,4,1,5,HOOK09,1103,1/20/22
3997,2,3,3,8,CRAZE33,1106,1/20/22
3998,2,6,0,8,SMALL64,1124,1/20/22
3999,2,6,0,8,SMALL65,1127,1/20/22
4000,1,5,1,7,BALL29,1130,1/20/22
4001,3,6,4,13,BALL64,1145,1/20/22
4002,1,5,3,9,FURY07,1142,1/20/22
4003,1,6,2,9,PHNTM,1148,1/20/22
4004,2,5,1,8,BALL02,1132,1/20/22
4005,1,5,3,9,EPIC07,1203,1/20/22
4006,2,6,4,12,GHOST53,1206,1/20/22
4007,0,6,4,10,CRAZE42,1221,1/20/22
4008,1,4,2,7,CRAZE14,1212,1/20/22
4009,2,3,2,7,HANG51,1148,1/20/22
4010,1,3,3,7,HANG52,1148,1/20/22
4011,1,5,3,9,EPIC02,1209,1/20/22
4012,0,4,2,6,HOOK05,1230,1/20/22
4013,1,6,4,11,HOOK33,1154,1/20/22
4014,0,7,1,8,BALL42,1157,1/20/22
4015,0,6,4,10,CRAZE22,1227,1/20/22
4016,1,2,6,9,STAB11,1236,1/20/22
4017,1,2,0,3,STAB12,1239,1/20/22
4018,0,5,2,7,HOOK01,1242,1/20/22
4019,1,4,2,7,COACH21,1245,1/20/22
4020,1,4,0,5,COACH22,1248,1/20/22
4021,1,6,3,10,SPECK48,1300,1/20/22
4022,0,3,2,5,HOOK59,1330,1/20/22
4023,1,5,1,7,PAWS79,1406,1/20/22
4024,1,5,3,9,SHINR81,1406,1/20/22
4025,1,5,4,10,SHINR82,1409,1/20/22
4026,2,3,2,7,BALL14,1403,1/20/22
4027,0,5,1,6,DAWG04,1418,1/20/22
4028,0,4,1,5,PAWS88,1421,1/20/22
4029,1,6,2,9,HANG51,1436,1/20/22
4030,3,6,1,10,HANG52,1439,1/20/22
4031,1,5,3,9,WIRE31,1424,1/20/22
4032,2,5,1,8,WIRE32,1427,1/20/22
4033,1,3,2,6,HOOK69,1448,1/20/22
4034,1,5,3,9,SCARE72,1442,1/20/22
4035,4,7,3,14,DRAGN62,1503,1/20/22
4036,1,3,6,10,PAWS46,1445,1/20/22
4037,2,3,6,11,DRAGN66,1500,1/20/22
4038,2,5,1,8,RENO71,1509,1/20/22
4039,1,5,1,7,RENO72,1512,1/20/22
4040,0,3,4,7,DRAGN61,1506,1/20/22
4041,0,3,5,8,DRAGN05,1424,1/20/22
4042,1,3,1,5,DRAGN76,1515,1/20/22
4043,1,3,1,5,CREEP31,1518,1/20/22
4044,1,3,2,6,CREEP32,1521,1/20/22
4045,2,4,2,8,BALL15,1524,1/20/22
4046,1,5,1,7,VEGA21,1527,1/20/22
4047,3,5,0,8,VEGA22,1530,1/20/22
4048,0,5,2,7,BALL29,1533,1/20/22
4049,2,3,0,5,BALL75,1536,1/20/22
4050,2,3,1,6,HOOK51,1745,1/20/22
4051,2,5,2,9,HOOK71,1742,1/20/22
4052,2,5,3,10,BALL44,1806,1/20/22
4053,1,4,6,11,RECON08,1800,1/20/22
4054,3,4,1,8,SMALL57,809,1/21/22
4055,0,3,3,6,RHINO99,800,1/21/22
4056,0,4,2,6,CRAZE42,827,1/21/22
4057,1,1,5,7,EPIC06,821,1/21/22
4058,2,4,4,10,GHOST53,812,1/21/22
4059,2,1,6,9,EPIC07,818,1/21/22
4060,1,3,2,6,CRAZE43,815,1/21/22
4061,0,3,2,5,CRAZE22,830,1/21/22
4062,1,3,3,7,SCARE13,836,1/21/22
4063,1,2,1,4,CRAZE21,839,1/21/22
4064,1,3,3,7,SCARE69,903,1/21/22
4065,2,3,2,7,DRAGN91,842,1/21/22
4066,3,4,3,10,DRAGN01,833,1/21/22
4067,2,3,2,7,CRAZE44,845,1/21/22
4068,1,3,1,5,DRAGN99,848,1/21/22
4069,2,5,8,15,SMALL10,0,1/21/22
4070,0,2,1,3,CRAZE79,857,1/21/22
4071,0,5,2,7,BALL35,915,1/21/22
4072,0,1,2,3,DRAGN61,924,1/21/22
4073,0,1,4,5,BAL27,921,1/21/22
4074,0,3,3,6,CRAZE46,918,1/21/22
4075,3,1,0,4,SHINR81,939,1/21/22
4076,3,2,2,7,SMALL20,936,1/21/22
4077,0,4,2,6,LOOT06,951,1/21/22
4078,0,3,2,5,HOOK69,930,1/21/22
4079,0,1,3,4,BALL11,945,1/21/22
4080,0,2,1,3,BALL62,933,1/21/22
4081,0,1,3,4,BALL18,948,1/21/22
4082,2,1,1,4,DRAGN38,957,1/21/22
4083,2,1,2,5,TORA21,1000,1/21/22
4084,1,2,4,7,GOLEM01,1006,1/21/22
4085,2,5,3,10,LODED1,1012,1/21/22
4086,2,2,2,6,PAWS33,1103,1/21/22
4087,1,3,2,6,EASY86,1106,1/21/22
4088,4,4,1,9,SMALL71,1139,1/21/22
4089,3,4,1,8,CRAZE45,1036,1/21/22
4090,2,4,7,13,EPIC07,1151,1/21/22
4091,1,4,3,8,GHOST53,1145,1/21/22
4092,1,3,5,9,SCARE13,1200,1/21/22
4093,2,3,1,6,DRAGN02,1206,1/21/22
4094,2,4,4,10,DRAGN05,1203,1/21/22
4095,0,4,3,7,PAWS42,1157,1/21/22
4096,1,3,4,8,EPIC06,1154,1/21/22
4097,2,3,1,6,CRAZE14,1148,1/21/22
4098,3,2,2,7,FURY04,1142,1/21/22
4099,2,3,4,9,SHINR81,1221,1/21/22
4100,2,3,3,8,SHINR82,1221,1/21/22
4101,0,3,2,5,DRAGN61,1227,1/21/22
4102,2,4,1,7,PAWS22,1236,1/21/22
4103,3,3,1,7,SMALL17,1232,1/21/22
4104,1,4,5,10,SCARE69,1248,1/21/22
4105,1,5,2,8,WIRE31,1242,1/21/22
4106,1,5,4,10,WIRE32,1242,1/21/22
4107,1,2,1,4,LOOKER1,1315,1/21/22
4108,1,4,1,6,LOOKER2,1318,1/21/22
4109,2,3,3,8,GIZMO11,1251,1/21/22
4110,2,3,2,7,GIZMO12,1257,1/21/22
4111,1,3,4,8,BALL11,1409,1/21/22
4112,2,3,0,5,SMALL61,1415,1/21/22
4113,2,3,0,5,GIZMO31,1403,1/21/22
4114,2,3,4,9,GIZMO32,1406,1/21/22
4115,3,3,1,7,SMALL60,1412,1/21/22
4116,2,4,2,8,HOOK86,1421,1/21/22
4117,0,2,1,3,HOOK69,1424,1/21/22
4118,0,2,4,6,PAWS69,1418,1/21/22
4119,1,4,2,7,HOOK51,1427,1/21/22
4120,1,3,1,5,HOOK33,14330,1/21/22
4121,2,3,1,6,LOOT51,1439,1/21/22
4122,1,3,2,6,TORA11,1503,1/21/22
4123,2,3,2,7,HOOK44,1545,1/21/22
4124,0,3,0,3,LOOT03,1536,1/21/22
4125,3,2,1,6,HOOK37,1521,1/21/22
4126,0,3,0,3,BALL21,1506,1/21/22
4127,3,3,0,6,TORA31,1451,1/21/22
4128,1,3,2,6,TORA32,14540,1/21/22
4129,2,3,2,7,BALL71,1448,1/21/22
4130,2,3,0,5,BALL45,1539,1/21/22
4131,0,3,0,3,HOOK35,1524,1/21/22
4132,0,3,1,4,HOOK76,1527,1/21/22
4133,2,3,1,6,BALL44,1549,1/21/22
4134,0,3,0,3,BALL29,1548,1/21/22
4135,1,3,2,6,SPECK48,1515,1/21/22
4136,2,3,0,5,LOST11,1509,1/21/22
4137,2,3,2,7,LOST12,1515,1/21/22
4138,0,2,0,2,BALL99,1506,1/21/22
4139,2,4,2,8,BALL42,1509,1/21/22
4140,4,3,2,9,SPECK02,1706,1/21/22
4141,1,3,1,5,BALL38,1709,1/21/22
4142,2,3,2,7,PAWS34,1703,1/21/22
4143,0,5,3,8,COBRA06,806,1/24/22
4144,1,5,4,10,BALL72,809,1/24/22
4145,1,3,3,7,WIRE31,812,1/24/22
4146,1,3,4,8,WIRE32,812,1/24/22
4147,2,3,4,9,DRAGN17,833,1/24/22
4148,2,3,4,9,LOADED1,839,1/24/22
4149,1,3,4,8,LOADED2,839,1/24/22
4150,0,3,4,7,DRAGN38,836,1/24/22
4151,0,4,4,8,EVIL02,845,1/24/22
4152,1,4,4,9,VEGA21,848,1/24/22
4153,1,4,5,10,VEGA22,851,1/24/22
4154,0,4,1,5,SPECK69,857,1/24/22
4155,0,1,0,1,CRAZE79,909,1/24/22
4156,1,3,8,12,RECON88,906,1/24/22
4157,3,5,4,12,HOOK28,921,1/24/22
4158,0,4,2,6,CRAZE48,912,1/24/22
4159,0,3,1,4,BALL44,915,1/24/22
4160,1,3,1,5,AXLE21,942,1/24/22
4161,1,3,2,6,AXLE22,954,1/24/22
4162,0,2,4,6,HOOK64,933,1/24/22
4163,2,4,0,6,GIZMO11,933,1/24/22
4164,4,4,2,10,GIZMO12,936,1/24/22
4165,0,4,4,8,HOOK32,948,1/24/22
4166,3,3,3,9,DRAGN66,1003,1/24/22
4167,0,3,1,4,DRAGN44,1009,1/24/22
4168,1,3,2,6,HOOK03,957,1/24/22
4169,1,2,2,5,DRAGN76,1006,1/24/22
4170,2,3,1,6,PHNTM03,1015,1/24/22
4171,1,5,2,8,DRAGN51,1012,1/24/22
4172,1,4,2,7,LOOKER11,1927,1/24/22
4173,1,4,2,7,LOOKER12,930,1/24/22
4174,0,2,1,3,HOOK69,1000,1/24/22
4175,1,4,3,8,TAUNT11,945,1/24/22
4176,1,4,1,6,TAUNT12,951,1/24/22
4177,2,2,0,4,SMALL61,1115,1/24/22
4178,0,4,2,6,CRAZE42,1121,1/24/22
4179,2,5,2,9,DRAGN33,1118,1/24/22
4180,1,6,1,8,DRAGN59,1124,1/24/22
4181,1,4,2,7,AXLE11,1133,1/24/22
4182,1,4,0,5,AXLE12,1136,1/24/22
4183,0,2,1,3,EPIC02,1130,1/24/22
4184,1,4,0,5,FURY02,1139,1/24/22
4185,2,4,3,9,FURY03,1142,1/24/22
4186,1,5,4,10,WIRE31,1151,1/24/22
4187,1,5,3,9,WIRE32,1154,1/24/22
4188,0,3,4,7,SPECK48,1200,1/24/22
4189,0,4,3,7,BALL81,1157,1/24/22
4190,0,4,2,6,PHNTM50,1203,1/24/22
4191,0,2,4,6,BALL31,1145,1/24/22
4192,1,4,7,12,COBRA05,1148,1/24/22
4193,1,3,6,10,SHINR81,1212,1/24/22
4194,1,3,7,11,SHINR82,1215,1/24/22
4195,3,2,3,8,SMALL07,1209,1/24/22
4196,0,4,2,6,BALL03,1227,1/24/22
4197,1,3,4,8,VEGA21,1221,1/24/22
4198,3,3,4,10,VEGA22,1224,1/24/22
4199,2,5,1,8,DRAGN21,1227,1/24/22
4200,1,2,5,8,RECON05,1127,1/24/22
4201,2,2,3,7,BALL18,1257,1/24/22
4202,3,4,0,7,BALL75,1303,1/24/22
4203,1,3,0,4,BALL45,1309,1/24/22
4204,2,2,2,6,SMALL37,1321,1/24/22
4205,0,2,3,5,HOOK61,1324,1/24/22
4206,2,3,2,7,BALL21,1309,1/24/22
4207,2,2,4,8,DRAGN662,1327,1/24/22
4208,1,3,0,4,COACH21,1315,1/24/22
4209,3,3,1,7,COACH22,1318,1/24/22
4210,2,3,1,6,RECON71,1430,1/24/22
4211,1,2,2,5,DRAGN67,1433,1/24/22
4212,1,5,1,7,DRAGN59,1454,1/24/22
4213,2,3,3,8,AXLE11,1439,1/24/22
4214,2,0,1,3,AXLE12,1439,1/24/22
4215,2,4,1,7,HANG51,1448,1/24/22
4216,2,4,2,8,HANG52,1448,1/24/22
4217,1,3,4,8,RECON99,1506,1/24/22
4218,1,4,2,7,PHNTM48,1509,1/24/22
4219,2,2,1,5,EPIC02,1500,1/24/22
4220,1,4,2,7,GHOST53,1457,1/24/22
4221,3,3,1,7,FURY02,1515,1/24/22
4222,2,4,1,7,SMALL12,1518,1/24/22
4223,1,3,3,7,FURY07,1512,1/24/22
4224,1,3,4,8,EPIC01,1503,1/24/22
4225,0,2,3,5,FURY03,1521,1/24/22
4226,4,2,3,9,scare13,1618,1/24/22
4227,0,3,6,9,fill 31,1624,1/24/22
4228,2,3,1,6,ball 29,1745,1/24/22
4229,2,3,2,7,ball 75,1748,1/24/22
4230,3,7,4,14,RECON01,800,1/25/22
4231,1,5,2,8,AXLE11,803,1/25/22
4232,1,5,2,8,AXEL12,806,1/25/22
4233,0,7,3,10,BALL36,818,1/25/22
4234,0,5,4,9,GHOST02,815,1/25/22
4235,2,6,4,12,WIRE31,809,1/25/22
4236,2,6,4,12,WIRE32,812,1/25/22
4237,2,7,5,14,GOLEM11,824,1/25/22
4238,2,7,8,17,GOLEM12,827,1/25/22
4239,2,3,4,9,DRAGN38,833,1/25/22
4240,1,5,3,9,STAB11,839,1/25/22
4241,1,5,8,14,STAB12,842,1/25/22
4242,2,5,1,8,DRAGN65,830,1/25/22
4243,0,6,2,8,HOOK21,845,1/25/22
4244,1,4,1,6,CREEP31,848,1/25/22
4245,1,4,2,7,CREEP32,951,1/25/22
4246,0,6,2,8,HOO36,836,1/25/22
4247,0,5,6,11,PHNTM64,909,1/25/22
4248,1,5,1,7,COACH21,854,1/25/22
4249,0,5,4,9,DRAGN86,900,1/25/22
4250,3,5,1,9,DRAGN03,915,1/25/22
4251,2,6,0,8,BALL02,912,1/25/22
4252,1,3,1,5,PHANTM45,918,1/25/22
4253,0,5,6,11,HOOK32,927,1/25/22
4254,0,3,2,5,HOOK69,921,1/25/22
4255,1,4,3,8,TORA11,933,1/25/22
4256,1,4,3,8,TORA12,936,1/25/22
4257,0,5,1,6,CRAZE21,906,1/25/22
4258,0,6,3,9,HOOK37,942,1/25/22
4259,0,7,3,10,BALL18,939,1/25/22
4260,1,6,4,11,HANG51,1006,1/25/22
4261,1,6,0,7,HANG52,1009,1/25/22
4262,1,4,1,6,GIZMO11,948,1/25/22
4263,1,4,1,6,GIMO12,951,1/25/22
4264,1,5,5,11,LOADED1,954,1/25/22
4265,1,5,3,9,LOADED2,957,1/25/22
4266,0,6,3,9,DRAGN02,1015,1/25/22
4267,0,6,1,7,DRAGN71,1003,1/25/22
4268,1,5,3,9,HOOK44,1000,1/25/22
4269,0,4,2,6,PHNTM03,1012,1/25/22
4270,0,5,3,8,DRAGN05,1018,1/25/22
4271,2,6,2,10,SMALL42,1030,1/25/22
4272,1,5,1,7,DRAGN55,1024,1/25/22
4273,1,4,2,7,CRAZE42,1030,1/25/22
4274,1,5,1,7,DRAGN59,1027,1/25/22
4275,1,5,4,10,EPIC09,1118,1/25/22
4276,1,7,3,11,EPIC02,1121,1/25/22
4277,1,6,0,7,GHOST53,1115,1/25/22
4278,1,7,2,10,EPIC06,1124,1/25/22
4279,2,4,0,6,PHNTM48,1130,1/25/22
4280,0,7,4,11,EPIC01,1127,1/25/22
4281,1,5,1,7,FURY01,1132,1/25/22
4282,0,7,3,10,FURY03,1136,1/25/22
4283,0,5,4,9,COBRA08,1154,1/25/22
4284,0,4,2,6,AXLE11,1145,1/25/22
4285,1,7,1,9,GHOST69,1142,1/25/22
4286,1,7,5,13,FURY02,1139,1/25/22
4287,0,4,5,9,AXLE12,1148,1/25/22
4288,0,5,5,10,PAWS46,1151,1/25/22
4289,1,5,4,10,WIRE31,1157,1/25/22
4290,1,5,7,13,WIRE32,1200,1/25/22
4291,1,6,5,12,HOOK38,1212,1/25/22
4292,1,4,4,9,TORA31,1227,1/25/22
4293,1,4,6,11,TORA32,1227,1/25/22
4294,2,4,2,8,CRAZE43,1215,1/25/22
4295,1,5,3,9,VEGA21,1218,1/25/22
4296,2,5,6,13,VEGA22,1221,1/25/22
4297,0,5,0,5,BALL75,1321,1/25/22
4298,0,5,0,5,PAWS16,1327,1/25/22
4299,3,3,2,8,BALL02,1318,1/25/22
4300,1,5,2,8,BALL89,1333,1/25/22
4301,0,5,6,11,PHNTM69,1330,1/25/22
4302,4,3,3,10,CRAZE66,1336,1/25/22
4303,2,8,1,11,SMALL40,1324,1/25/22
4304,1,3,1,5,DRAGN68,1342,1/25/22
4305,1,3,0,4,DRAGN61,1339,1/25/22
4306,2,3,5,10,SMALL70,1436,1/25/22
4307,2,3,1,6,SMALL69,1433,1/25/22
4308,2,6,1,9,DRAGN72,1430,1/25/22
4309,1,6,3,10,SCARE59,1439,1/25/22
4310,0,6,0,6,BALL42,1430,1/25/22
4311,1,7,4,12,SCARE13,1448,1/25/22
4312,1,6,2,9,DRAGN96,1445,1/25/22
4313,1,5,1,7,RENO71,1451,1/25/22
4314,1,5,1,7,RENO72,1454,1/25/22
4315,0,5,0,5,RECON99,1500,1/25/22
4316,1,3,7,11,EPIC09,1509,1/25/22
4317,0,5,1,6,DRAGN05,1442,1/25/22
4318,0,7,3,10,PHNTM48,1503,1/25/22
4319,2,4,0,6,SMALL10,1512,1/25/22
4320,3,5,5,13,EPIC07,1506,1/25/22
4321,0,6,1,7,BALL44,1430,1/25/22
4322,1,5,2,8,FURY07,1518,1/25/22
4323,3,6,3,12,GHOST69,1524,1/25/22
4324,0,5,5,10,CRAZE46,809,1/26/22
4325,0,6,6,12,Ball36,806,1/26/22
4326,0,7,8,15,Ball31,800,1/26/22
4327,1,5,6,12,ETCH41,818,1/26/22
4328,1,5,7,13,ETCH42,821,1/26/22
4329,1,6,5,12,HOOK38,818,1/26/22
4330,1,6,3,10,BALL45,812,1/26/22
4331,1,5,1,7,DRAGN83,836,1/26/22
4332,2,3,4,9,PHNTM50,815,1/26/22
4333,0,7,1,8,CRAZE79,827,1/26/22
4334,1,4,5,10,SHINR81,830,1/26/22
4335,1,4,2,7,SHINR82,833,1/26/22
4336,1,5,4,10,TORA31,845,1/26/22
4337,2,5,2,9,TORA32,848,1/26/22
4338,0,5,1,6,FURY03,839,1/26/22
4339,2,7,4,13,COACH21,821,1/26/22
4340,2,7,3,12,COACH22,821,1/26/22
4341,1,7,3,11,RECON69,903,1/26/22
4342,1,5,0,6,RECON81,906,1/26/22
4343,1,3,1,5,DRAGN63,912,1/26/22
4344,0,2,2,4,CRAZE11,909,1/26/22
4345,2,5,2,9,SMALL77,857,1/26/22
4346,2,7,2,11,DRAGN62,848,1/26/22
4347,2,5,4,11,DRAGN66,915,1/26/22
4348,1,8,2,11,LOADED1,918,1/26/22
4349,1,8,2,11,LOADED2,921,1/26/22
4350,0,5,3,8,HOOK61,936,1/26/22
4351,1,6,1,8,TORA11,939,1/26/22
4352,1,6,1,8,TORA12,942,1/26/22
4353,0,5,0,5,PHNTM45,951,1/26/22
4354,2,7,1,10,DRAGN72,1009,1/26/22
4355,1,8,4,13,RECON01,1003,1/26/22
4356,2,5,4,11,PAWS81,954,1/26/22
4357,0,5,2,7,HOOK05,945,1/26/22
4358,1,5,3,9,DRAGN44,1012,1/26/22
4359,0,5,0,5,CRAZE21,1015,1/26/22
4360,0,6,3,9,CRAZE42,1027,1/26/22
4361,1,6,0,7,HANG51,1018,1/26/22
4362,1,6,1,8,HANG52,1021,1/26/22
4363,2,6,2,10,HOOK59,933,1/26/22
4364,2,7,2,11,EPIC02,1115,1/26/22
4365,1,7,2,10,EPIC06,1118,1/26/22
4366,3,6,1,10,SMALL66,1130,1/26/22
4367,0,7,3,10,FURY04,1136,1/26/22
4368,3,6,2,11,VEGA21,1124,1/26/22
4369,3,5,1,9,FURY03,1133,1/26/22
4370,2,5,5,12,FURY01,1142,1/26/22
4371,0,3,0,3,RECON09,1139,1/26/22
4372,1,5,7,13,SHINR81,1209,1/26/22
4373,2,5,3,10,DRAGN38,1206,1/26/22
4374,1,7,2,10,AXLE11,1215,1/26/22
4375,4,5,2,11,CRAZE66,1221,1/26/22
4376,0,6,4,10,GHOST48,1203,1/26/22
4377,1,5,0,6,DRAGN69,1233,1/26/22
4378,0,7,2,9,BALL42,1227,1/26/22
4379,0,3,6,9,DRAGN32,1230,1/26/22
4380,0,4,4,8,DRAGN91,1306,1/27/22
4381,2,3,0,5,PAWS48,1457,1/27/22
4382,1,4,0,5,Gizmo11,1451,1/27/22
4383,3,4,0,7,SLOW21,1415,1/27/22
4384,3,5,2,10,Taunt11,945,1/27/22
4385,2,6,3,11,DRAGN01,1457,1/27/22
4386,1,4,2,7,Gizmo31,1500,1/27/22
4387,1,5,3,9,AXLE 11,806,1/28/22
4388,1,5,3,9,AXLE 12,806,1/28/22
4389,1,3,0,4,EASY 86,801,1/28/22
4390,0,3,4,7,HOOK 61,815,1/28/22
4391,1,3,4,8,CRAZE 42,842,1/28/22
4392,2,3,4,9,DRAGON 44,833,1/28/22
4393,1,6,1,8,HANG 51,824,1/28/22
4394,1,6,2,9,HANG 52,824,1/28/22
4395,0,2,2,4,CRAZE 48,818,1/28/22
4396,3,5,2,10,SMALL 70,836,1/28/22
4397,0,3,7,10,DRAGN 55,845,1/28/22
4398,2,8,3,13,DRAGN 72,821,1/28/22
4399,0,3,2,5,DRAGN 51,839,1/28/22
4400,2,3,2,7,HOOK 91,851,1/28/22
4401,3,3,1,7,DRAGN 05,848,1/28/22
4402,2,5,3,10,SLOW 11,857,1/28/22
4403,2,5,2,9,SLOW 12,857,1/28/22
4404,1,6,6,13,LOST 41,921,1/28/22
4405,1,6,2,9,LOST 42,921,1/28/22
4406,1,3,1,5,CRAZE 79,854,1/28/22
4407,1,6,7,14,TORA 31,906,1/28/22
4408,1,6,5,12,TORA 32,906,1/28/22
4409,2,4,1,7,SLOW 21,909,1/28/22
4410,1,4,6,11,SLOW 22,909,1/28/22
4411,1,3,4,8,CRAZE 54,942,1/28/22
4412,1,5,3,9,LOADED 01,1000,1/28/22
4413,3,8,1,12,HOOK 01,954,1/28/22
4414,1,5,5,11,EPIC 01,957,1/28/22
4415,0,7,1,8,PAWS 34,1006,1/28/22
4416,2,8,2,12,GIZMO 31,930,1/28/22
4417,1,8,0,9,GIZMO 32,930,1/28/22
4418,3,4,3,10,BALL 38,1009,1/28/22
4419,2,3,1,6,LOOKER 01,948,1/28/22
4420,2,3,1,6,LOOKER 02,948,1/28/22
4421,0,5,2,7,BALL 64,945,1/28/22
4422,1,6,1,8,RENO 71,1012,1/28/22
4423,1,6,1,8,RENO 72,1012,1/28/22
4424,2,3,2,7,LOOT 50,1024,1/28/22
4425,0,4,4,8,BADER 01,1027,1/28/22
4426,0,3,0,3,BALL 61,1030,1/28/22
4427,1,5,0,6,SHINR 81,1036,1/28/22
4428,3,5,0,8,SHINR 82,1036,1/28/22
4429,0,0,4,4,DAWG 04,1021,1/28/22
4430,2,4,6,12,TORA 21,936,1/28/22
4431,2,4,4,10,TORA 22,936,1/28/22
4432,2,5,1,8,EPIC06,1124,1/28/22
4433,0,6,1,7,LOADED2,1003,1/28/22
4434,1,3,0,4,EPIC02,1133,1/28/22
4435,2,4,2,8,BALL29,1118,1/28/22
4436,1,5,3,9,EPIC09,1136,1/28/22
4437,0,3,4,7,HOOK22,927,1/28/22
4438,0,4,6,10,Dragn55,1139,1/28/22
4439,2,5,0,7,Small63,1121,1/28/22
4440,2,7,2,11,PHNTM48,1130,1/28/22
4441,1,8,0,9,Ghost53,1127,1/28/22
4442,3,8,1,12,HOOK01,1142,1/28/22
4443,1,4,1,6,Ball42,1145,1/28/22
4444,0,2,2,4,BALL67,1148,1/28/22
4445,1,2,0,3,BALL63,1148,1/28/22
4446,1,6,3,10,AXLE11,1154,1/28/22
4447,1,6,1,8,AXLE12,1157,1/28/22
4448,0,3,2,5,CRAZE86,1206,1/28/22
4449,1,2,2,5,BALL63,1148,1/28/22
4450,1,3,2,6,SCARE29,1209,1/28/22
4451,2,3,5,10,ETCH41,1200,1/28/22
4452,2,3,5,10,ETCH42,1203,1/28/22
4453,2,3,1,6,EASY31,0,1/28/22
4454,1,2,0,3,RENO71,1321,1/28/22
4455,1,2,4,7,RENO72,1324,1/28/22
4456,3,3,1,7,SMALL43,1333,1/28/22
4457,2,5,5,12,DRAGN71,1309,1/28/22
4458,0,2,2,4,DRAGN61,1324,1/28/22
4459,0,4,3,7,WIRE31,1327,1/28/22
4460,0,4,3,7,WIRE32,1330,1/28/22
4461,1,7,1,9,STAB11,1348,1/28/22
4462,1,7,1,9,STAB12,1351,1/28/22
4463,3,3,5,11,DRAGN02,1345,1/28/22
4464,4,3,3,10,Ball35,1354,1/28/22
4465,0,3,3,6,BALL02,1342,1/28/22
4466,1,4,2,7,HANG51,1336,1/28/22
4467,1,4,2,7,HANG52,1339,1/28/22
4468,1,1,5,7,BADGR01,1439,1/28/22
4469,0,0,0,0,FURY01,0,1/28/22
4470,2,2,4,8,FURY01,1433,1/28/22
4471,3,2,1,6,CREEP31,1448,1/28/22
4472,1,2,0,3,CREEP32,1451,1/28/22
4473,1,3,4,8,GOLEM11,1442,1/28/22
4474,1,5,4,10,GOLEM12,1445,1/28/22
4475,1,1,4,6,SPOT91,1454,1/28/22
4476,1,1,2,4,SPOT92,1457,1/28/22
4477,0,0,2,2,BALL76,1436,1/28/22
4478,0,0,5,5,DRAGN69,1509,1/28/22
4479,1,4,5,10,EPIC09,1506,1/28/22
4480,0,0,5,5,SCARE13,1500,1/28/22
4481,1,5,2,8,SCARE09,1515,1/28/22
4482,1,2,1,4,EASY86,1520,1/28/22
4483,2,2,0,4,SMALL10,1512,1/28/22
4484,1,4,0,5,GHOST53,1518,1/28/22
4485,0,0,6,6,PAWS13,1524,1/28/22
4486,1,3,2,6,GHOST69,1521,1/28/22
4487,0,2,3,5,DAWG02,1636,1/28/22
4488,0,0,3,3,CRAZE66,1624,1/28/22
4489,4,2,0,6,TORA11,1642,1/28/22
4490,4,2,1,7,TORA12,1645,1/28/22
4491,2,3,0,5,BALL19,1639,1/28/22
4492,1,2,5,8,BALL31,0,1/31/22
4493,1,5,3,9,FURY02,0,1/31/22
4494,2,3,7,12,HOOK37,0,1/31/22
4495,0,3,3,6,GHOST69,0,1/31/22
4496,1,5,3,9,FURY01,0,1/31/22
4497,0,1,1,2,DRAGN38,0,1/31/22
4498,2,5,4,11,BALL64,0,1/31/22
4499,1,3,3,7,EPIC02,0,1/31/22
4500,1,3,7,11,EPIC09,0,1/31/22
4501,0,2,0,2,CRAZE43,0,1/31/22
4502,2,3,6,11,EPIC06,0,1/31/22
4503,3,3,1,7,SMALL77,0,1/31/22
4504,1,1,2,4,WIRE31,0,1/31/22
4505,1,1,2,4,WIRE32,0,1/31/22
4506,0,4,3,7,GHOST02,0,1/31/22
4507,1,3,2,6,SHINR81,0,1/31/22
4508,1,3,1,5,SHINR82,0,1/31/22
4509,1,4,5,10,GHOST53,0,1/31/22
4510,0,3,0,3,DRAGN51,0,1/31/22
4511,2,4,2,8,PHNTM45,0,1/31/22
4512,0,3,2,5,BALL88,0,1/31/22
4513,2,3,1,6,GIZMO11,0,1/31/22
4514,1,3,0,4,GIZMO12,0,1/31/22
4515,1,3,3,7,HANG51,0,1/31/22
4516,1,3,2,6,HANG52,0,1/31/22
4517,4,2,0,6,BALL45,0,1/31/22
4518,2,2,3,7,DRAGN72,1121,1/31/22
4519,3,2,1,6,DRAGN76,1124,1/31/22
4520,0,2,2,4,PAWS34,1206,1/31/22
4521,2,3,0,5,TORA21,1142,1/31/22
4522,2,3,2,7,TORA21,1142,1/31/22
4523,1,2,3,6,CREEP31,1154,1/31/22
4524,1,2,1,4,CREEP32,1157,1/31/22
4525,2,2,3,7,COACH21,1148,1/31/22
4526,2,2,4,8,COACH22,1151,1/31/22
4527,2,4,5,11,BALL36,1215,1/31/22
4528,2,4,4,10,SMALL14,1224,1/31/22
4529,1,2,6,9,GHOST69,1227,1/31/22
4530,1,2,6,9,FURY01,1230,1/31/22
4531,1,2,1,4,TORA41,1245,1/31/22
4532,2,2,1,5,CRAZE13,1318,1/31/22
4533,3,6,2,11,BALL77,1315,1/31/22
4534,2,2,0,4,LOADED01,954,1/31/22
4535,1,2,1,4,TORA42,948,1/31/22
4536,1,2,0,3,LOADED01,951,1/31/22
4537,0,2,4,6,TORA12,1000,1/31/22
4538,0,3,0,3,HOOK03,0,1/31/22
4539,0,2,1,3,HOOK83,0,1/31/22
4540,1,2,6,9,EPIC09,0,1/31/22
4541,2,2,2,6,DRAGN91,0,1/31/22
4542,3,3,2,8,SMALL66,0,1/31/22
4543,3,3,2,8,SMALL67,0,1/31/22
4544,0,2,4,6,RECON69,0,1/31/22
4545,0,2,6,8,HOOK81,0,1/31/22
4546,1,3,2,6,DRAGN55,0,1/31/22
4547,0,4,1,5,HOOK59,0,1/31/22
4548,1,2,1,4,SCARE17,0,1/31/22
4549,2,3,6,11,EPIC01,0,1/31/22
4550,1,2,6,9,BALL38,0,1/31/22
4551,4,2,1,7,SMALL71,0,1/31/22
4552,0,2,1,3,HOOK61,0,1/31/22
4553,0,2,6,8,DRAGN62,0,1/31/22
4554,0,3,2,5,BALL88,0,1/31/22
4555,2,2,6,10,BALL35,0,1/31/22
4556,3,3,3,9,SMALL11,0,1/31/22
4557,3,2,1,6,SLOW71,0,1/31/22
4558,1,2,0,3,SLOW72,0,1/31/22
4559,0,2,4,6,TORA11,0,1/31/22
4560,2,2,3,7,HOOK38,0,1/31/22
4561,2,3,0,5,DRAGN71,0,1/31/22
4562,1,2,4,7,BALL19,0,1/31/22
4563,2,0,3,5,HOOK44,0,1/31/22
4564,2,4,1,7,SMALL17,0,1/31/22
4565,3,2,2,7,HOOK05,0,1/31/22
4566,4,2,2,8,BALL18,0,1/31/22
4567,1,2,0,3,DRAGN19,1618,1/31/22
4568,6,5,1,12,LOOT06,1655,1/31/22
4569,2,3,4,9,SPECK48,1700,1/31/22
4570,2,2,4,8,BALL44,1710,1/31/22
4571,1,3,2,6,BALL45,1715,1/31/22
4572,1,3,1,5,BALL67,1735,1/31/22
4573,1,2,2,5,DRAGN91,1806,1/31/22
4574,1,1,3,5,DRAGN62,1803,1/31/22
4575,2,5,5,12,COACH21,806,2/1/22
4576,2,5,3,10,COACH22,809,2/1/22
4577,0,2,3,5,HOOK61,839,2/1/22
4578,0,4,3,7,FURY01,818,2/1/22
4579,0,4,4,8,FURY02,821,2/1/22
4580,1,4,3,8,HANG51,842,2/1/22
4581,1,4,7,12,HANG52,845,2/1/22
4582,2,3,2,7,DRAGN63,854,2/1/22
4583,2,2,5,9,DRAGN66,836,2/1/22
4584,1,5,3,9,CRAZE77,857,2/1/22
4585,2,5,1,8,GIZMO31,909,2/1/22
4586,1,5,0,6,GIZMO32,912,2/1/22
4587,1,4,6,11,LOADED1,918,2/1/22
4588,1,4,1,6,LOADED2,921,2/1/22
4589,1,6,3,10,CREEP31,903,2/1/22
4590,1,6,2,9,CREEP32,906,2/1/22
4591,0,6,6,12,HOOK07,906,2/1/22
4592,1,4,4,9,EPIC09,824,2/1/22
4593,1,5,1,7,AXEL11,924,2/1/22
4594,1,5,0,6,AXEL12,927,2/1/22
4595,0,7,2,9,BALL25,921,2/1/22
4596,0,3,3,6,HOOK19,1112,2/1/22
4597,1,3,0,4,SHINR81,1103,2/1/22
4598,1,3,0,4,SHINR82,1106,2/1/22
4599,0,3,0,3,DRAGN76,1109,2/1/22
4600,0,4,0,4,RECON09,1130,2/1/22
4601,1,4,1,6,RECON08,1145,2/1/22
4602,3,6,1,10,BALL18,1145,2/1/22
4603,2,2,3,7,GIZMO11,1136,2/1/22
4604,1,2,3,6,GIZMO12,1139,2/1/22
4605,1,3,2,6,GHOST69,1151,2/1/22
4606,2,5,7,14,SLOW71,1203,2/1/22
4607,1,5,1,7,SLOW72,1206,2/1/22
4608,1,4,6,11,FURY02,1148,2/1/22
4609,1,6,5,12,EPIC07,1154,2/1/22
4610,1,3,5,9,EPIC01,1157,2/1/22
4611,1,6,3,10,SCARE13,1106,2/1/22
4612,1,4,0,5,RECON71,1133,2/1/22
4613,1,3,0,4,AXLE11,1400,2/1/22
4614,1,3,2,6,AXLE12,1403,2/1/22
4615,0,2,2,4,PAWS79,1409,2/1/22
4616,1,1,3,5,ETCH41,1415,2/1/22
4617,1,1,2,4,ETCH42,1418,2/1/22
4618,0,2,3,5,DRAGN55,1421,2/1/22
4619,0,2,2,4,DRAGN35,1412,2/1/22
4620,0,3,8,11,DRAGN33,1424,2/1/22
4621,0,4,4,8,DRAGN06,1427,2/1/22
4622,0,1,5,6,HOOK46,1430,2/1/22
4623,2,1,3,6,CRAZE66,1433,2/1/22
4624,0,3,3,6,DRAGN75,1439,2/1/22
4625,0,2,7,9,EPIC01,821,2/7/22
4626,1,1,3,5,COACH21,809,2/7/22
4627,1,0,6,7,WIRE31,836,2/7/22
4628,2,2,8,12,GHOST53,824,2/7/22
4629,1,1,3,5,CREEP31,842,2/7/22
4630,1,1,7,9,EPIC09,827,2/7/22
4631,0,0,7,7,EPIC02,830,2/7/22
4632,1,1,3,5,CRAZE43,833,2/7/22
4633,0,7,5,12,DRAGN55,857,2/7/22
4634,0,3,7,10,DRAGN06,906,2/7/22
4635,1,2,1,4,STAB11,851,2/7/22
4636,2,2,2,6,STAB12,851,2/7/22
4637,0,2,6,8,DRAGN33,903,2/7/22
4638,0,6,2,8,CRAZE76,848,2/7/22
4639,0,2,5,7,CREEP32,845,2/7/22
4640,0,2,4,6,CRAZE21,909,2/7/22
4641,2,2,3,7,PHNTM03,912,2/7/22
4642,0,2,3,5,DRAGN68,927,2/7/22
4643,1,2,4,7,DRAGN66,930,2/7/22
4644,0,4,9,13,PHNTM51,900,2/7/22
4645,2,1,2,5,RECON08,936,2/7/22
4646,2,4,2,8,GIZMO31,939,2/7/22
4647,2,4,5,11,GIZMO32,939,2/7/22
4648,0,3,0,3,BALL88,933,2/7/22
4649,1,1,2,4,LOOKER01,1006,2/7/22
4650,1,1,1,3,LOOKER02,1006,2/7/22
4651,0,3,4,7,BALL36,957,2/7/22
4652,1,3,3,7,BALL38,1000,2/7/22
4653,1,3,4,8,TORA21,945,2/7/22
4654,1,2,2,5,TORA22,948,2/7/22
4655,1,2,1,4,LOST11,951,2/7/22
4656,1,2,1,4,LOST12,954,2/7/22
4657,2,2,5,9,LOADED1,1027,2/7/22
4658,2,2,3,7,LOADED2,1027,2/7/22
4659,2,5,3,10,HOOK59,1015,2/7/22
4660,2,5,4,11,HOOK17,1018,2/7/22
4661,2,2,4,8,HANG51,1100,2/7/22
4662,2,2,8,12,HANG52,1100,2/7/22
4663,2,1,1,4,DRAGN75,1106,2/7/22
4664,1,2,3,6,WIRE31,1109,2/7/22
4665,2,2,0,4,WIRE32,1109,2/7/22
4666,2,2,1,5,SHINER81,1124,2/7/22
4667,2,2,1,5,SHINER82,1115,2/7/22
4668,1,2,4,7,BALL45,1127,2/7/22
4669,0,4,5,9,COBRA01,1139,2/7/22
4670,0,4,3,7,GHOST02,1136,2/7/22
4671,1,2,2,5,AXLE11,1148,2/7/22
4672,1,2,2,5,AXLE12,1148,2/7/22
4673,1,2,1,4,COACH21,1142,2/7/22
4674,1,2,0,3,COACH22,1145,2/7/22
4675,1,1,6,8,EPIC06,1157,2/7/22
4676,1,1,6,8,EPIC09,1200,2/7/22
4677,4,1,7,12,EPIC01,1154,2/7/22
4678,0,1,5,6,FURY02,1218,2/7/22
4679,0,1,8,9,HOOK46,1012,2/7/22
4680,1,1,2,4,BALL03,1221,2/7/22
4681,0,1,2,3,BALL61,1212,2/7/22
4682,0,3,2,5,BALL05,1233,2/7/22
4683,0,1,3,4,DRAGN69,1406,2/7/22
4684,0,4,6,10,DRAGN06,1427,2/7/22
4685,2,4,2,8,VEGA21,1415,2/7/22
4686,2,4,4,10,VEGA22,1215,2/7/22
4687,0,3,3,6,BALL88,1403,2/7/22
4688,1,4,4,9,BALL45,1412,2/7/22
4689,1,3,2,6,RECON69,1409,2/7/22
4690,1,1,3,5,AXLE11,1421,2/7/22
4691,1,1,2,4,AXLE12,1421,2/7/22
4692,3,3,7,13,DRAGN63,1430,2/7/22
4693,2,3,4,9,DROKE16,14482,2/7/22
4694,2,3,12,17,DRAGN66,1433,2/7/22
4695,3,1,3,7,SMALL71,1439,2/7/22
4696,3,1,4,8,SMALL70,1436,2/7/22
4697,2,1,2,5,SMALL72,1442,2/7/22
4698,2,2,1,5,DRAGN91,1442,2/7/22
4699,0,3,1,4,DRAGN76,1454,2/7/22
4700,1,2,2,5,WIRE31,1500,2/7/22
4701,3,2,1,6,WIRE32,1500,2/7/22
4702,4,4,1,9,DRAGN71,1457,2/7/22
4703,2,1,5,8,GHOST48,1836,2/7/22
4704,1,3,5,9,SCARE72,957,2/8/22
4705,1,2,3,6,EASY86,801,2/8/22
4706,1,3,3,7,SPECK02,800,2/8/22
4707,3,1,2,6,SMALL55,803,2/8/22
4708,1,1,4,6,RECON76,809,2/8/22
4709,2,2,3,7,PAWS34,806,2/8/22
4710,1,3,3,7,VEGA21,815,2/8/22
4711,3,3,2,8,VEGA22,815,2/8/22
4712,0,3,1,4,EPIC02,830,2/8/22
4713,0,2,7,9,EPIC01,827,2/8/22
4714,1,2,3,6,GHOST33,833,2/8/22
4715,1,2,3,6,CRAZE43,836,2/8/22
4716,1,1,3,5,CRAZE45,845,2/8/22
4717,1,1,6,8,EPIC07,839,2/8/22
4718,0,1,3,4,FURY02,848,2/8/22
4719,0,1,2,3,FURY03,842,2/8/22
4720,0,2,1,3,AMM09,903,2/8/22
4721,0,2,3,5,FURY07,851,2/8/22
4722,1,2,1,4,CREEP31,857,2/8/22
4723,2,2,0,4,CREEP32,900,2/8/22
4724,0,1,4,5,BALL04,854,2/8/22
4725,2,2,1,5,STAB11,909,2/8/22
4726,2,2,4,8,STAB12,906,2/8/22
4727,0,4,2,6,CRAZE42,912,2/8/22
4728,1,2,2,5,AXLE11,939,2/8/22
4729,1,2,1,4,AXLE12,942,2/8/22
4730,1,3,2,6,HANG51,918,2/8/22
4731,1,3,3,7,HANG52,921,2/8/22
4732,1,2,0,3,POST61,924,2/8/22
4733,1,2,0,3,POST62,927,2/8/22
4734,3,2,1,6,SMALL16,930,2/8/22
4735,3,2,2,7,SMALL11,915,2/8/22
4736,0,2,3,5,BALL89,933,2/8/22
4737,0,1,2,3,RECON08,936,2/8/22
4738,2,4,3,9,BALL35,954,2/8/22
4739,2,2,2,6,TORA21,945,2/8/22
4740,1,2,2,5,TORA22,948,2/8/22
4741,1,1,2,4,LOADED1,1000,2/8/22
4742,1,1,2,4,LOADED2,1003,2/8/22
4743,0,3,8,11,SPECK48,957,2/8/22
4744,0,3,2,5,HOOK46,1015,2/8/22
4745,1,1,2,4,BALL02,951,2/8/22
4746,2,1,2,5,TORA11,1012,2/8/22
4747,2,1,4,7,TORA12,1015,2/8/22
4748,3,3,3,9,ETCH41,1018,2/8/22
4749,2,3,3,8,ETCH42,1021,2/8/22
4750,0,1,2,3,DRAGN63,1100,2/8/22
4751,2,1,0,3,HOOK91,1024,2/8/22
4752,0,2,5,7,PAWS21,1012,2/8/22
4753,1,1,3,5,DRAGN66,1103,2/8/22
4754,1,1,2,4,DRAGN61,1106,2/8/22
4755,0,1,2,3,DRAGN68,1109,2/8/22
4756,4,1,1,6,PHNTM45,1112,2/8/22
4757,1,4,2,7,RENO71,1115,2/8/22
4758,1,4,3,8,REN072,1118,2/8/22
4759,3,1,3,7,DRAGN77,1121,2/8/22
4760,1,2,1,4,VEGA21,1127,2/8/22
4761,3,2,0,5,VEGA21,1127,2/8/22
4762,1,2,0,3,SHINR81,1130,2/8/22
4763,1,2,2,5,SHINR82,1133,2/8/22
4764,1,2,5,8,WIRE31,1145,2/8/22
4765,1,3,2,6,BALL44,1136,2/8/22
4766,4,1,1,6,SPOT91,1151,2/8/22
4767,1,1,3,5,EPIC06,1209,2/8/22
4768,1,2,5,8,EPIC09,1206,2/8/22
4769,4,2,6,12,EPIC01,1203,2/8/22
4770,1,2,8,11,EPIC02,1212,2/8/22
4771,1,1,4,6,STAB11,1157,2/8/22
4772,1,1,3,5,STAB12,1200,2/8/22
4773,0,3,2,5,FURY04,1218,2/8/22
4774,0,2,4,6,CRAZE14,1215,2/8/22
4775,2,2,3,7,RECON03,1227,2/8/22
4776,1,3,0,4,AXLE11,1233,2/8/22
4777,1,3,1,5,AXLE12,1236,2/8/22
4778,1,2,3,6,FURY01,1221,2/8/22
4779,0,2,1,3,SPECK69,1230,2/8/22
4780,1,4,2,7,COACH21,1239,2/8/22
4781,1,4,2,7,COACH22,1241,2/8/22
4782,1,2,3,6,HANG51,1400,2/8/22
4783,1,2,2,5,HANG52,1403,2/8/22
4784,0,5,3,8,CRAZE42,1418,2/8/22
4785,2,1,2,5,CREEP31,1406,2/8/22
4786,1,1,3,5,CREEP32,1409,2/8/22
4787,1,5,3,9,SCARE99,1424,2/8/22
4788,2,2,3,7,SMALL63,1421,2/8/22
4789,0,4,3,7,HOOK06,1430,2/8/22
4790,0,2,3,5,DRAGN05,1433,2/8/22
4791,2,2,5,9,DRAGN66,1439,2/8/22
4792,1,5,3,9,DRAGN12,1436,2/8/22
4793,2,4,3,9,DRAGN37,1457,2/8/22
4794,2,3,3,8,CRAZE44,1454,2/8/22
4795,0,2,1,3,DRAGN35,1500,2/8/22
4796,1,3,1,5,VEGA21,1503,2/8/22
4797,3,3,1,7,VEGA22,1506,2/8/22
4798,3,5,3,11,RENO71,1448,2/8/22
4799,1,5,1,7,RENO72,1451,2/8/22
4800,2,1,1,4,BALL44,1809,2/8/22
4801,2,2,2,6,BALL42,1812,2/8/22
4802,0,3,3,6,RECON77,803,2/9/22
4803,1,1,3,5,STAB11,806,2/9/22
4804,3,2,3,8,CRAZE43,812,2/9/22
4805,0,2,3,5,COBRA06,800,2/9/22
4806,1,1,4,6,EPIC02,821,2/9/22
4807,0,1,5,6,EPIC07,824,2/9/22
4808,0,2,2,4,CRAZE45,830,2/9/22
4809,2,1,3,6,EPIC01,815,2/9/22
4810,1,2,4,7,EPIC06,818,2/9/22
4811,0,2,3,5,FURY02,827,2/9/22
4812,0,2,1,3,FURY04,836,2/9/22
4813,0,2,5,7,FURY03,833,2/9/22
4814,2,2,1,5,ETCH41,842,2/9/22
4815,0,0,1,1,FURY01,839,2/9/22
4816,1,2,5,8,WIRE31,848,2/9/22
4817,1,1,4,6,AXEL11,854,2/9/22
4818,0,2,4,6,DRAGN51,915,2/9/22
4819,3,2,2,7,GIZMO11,900,2/9/22
4820,1,5,0,6,EASY42,840,2/9/22
4821,1,1,4,6,CREEP31,909,2/9/22
4822,1,4,5,10,LOOT51,906,2/9/22
4823,2,3,1,6,SMALL13,921,2/9/22
4824,1,2,3,6,HOOK46,918,2/9/22
4825,2,1,0,3,SMALL22,942,2/9/22
4826,0,1,4,5,DRAGN66,930,2/9/22
4827,1,1,1,3,PHNTM45,927,2/9/22
4828,2,1,6,9,SLOW41,948,2/9/22
4829,1,2,1,4,COACH21,936,2/9/22
4830,4,3,1,8,HOOK99,933,2/9/22
4831,4,1,2,7,GIZMO21,954,2/9/22
4832,2,2,1,5,LOADED1,1003,2/9/22
4833,1,0,2,3,DRAGN52,1000,2/9/22
4834,2,2,1,5,LOST11,1006,2/9/22
4835,2,2,1,5,SMALL37,1021,2/9/22
4836,0,5,5,10,BALL35,1012,2/9/22
4837,2,2,0,4,BALL89,1030,2/9/22
4838,1,1,0,2,HOOK59,945,2/9/22
4839,0,5,2,7,PAWS88,1018,2/9/22
4840,0,2,0,2,HOOK06,1027,2/9/22
4841,3,3,0,6,RENO71,1103,2/9/22
4842,0,1,0,1,DRAGN69,1024,2/9/22
4843,1,0,3,4,DUKE16,1100,2/9/22
4844,2,1,2,5,TORA11,1115,2/9/22
4845,1,1,3,5,SHINR81,1109,2/9/22
4846,1,0,2,3,WIRE31,1121,2/9/22
4847,2,0,2,4,SMALL65,1127,2/9/22
4848,0,3,3,6,COBRA01,1139,2/9/22
4849,0,3,2,5,BALL02,1142,2/9/22
4850,1,4,4,9,CREEP31,1151,2/9/22
4851,1,4,1,6,EASY42,1135,2/9/22
4852,2,3,4,9,VEGA21,1145,2/9/22
4853,0,2,5,7,EPIC09,1157,2/9/22
4854,3,2,3,8,EPIC07,1209,2/9/22
4855,2,3,3,8,RECON03,1212,2/9/22
4856,0,3,7,10,EPIC01,1200,2/9/22
4857,0,2,0,2,GHOST53,1203,2/9/22
4858,0,2,2,4,CRAZE14,1206,2/9/22
4859,0,1,4,5,GHOST69,1215,2/9/22
4860,2,2,1,5,SMALL12,1218,2/9/22
4861,1,3,6,10,AXLE11,1227,2/9/22
4862,3,2,3,8,SMALL13,1221,2/9/22
4863,1,1,2,4,HANG51,1233,2/9/22
4864,3,3,3,9,SPOT91,1239,2/9/22
4865,1,1,3,5,EASY88,1231,2/9/22
4866,0,4,6,10,DRAGN51,1415,2/9/22
4867,0,5,4,9,PHNTM51,1412,2/9/22
4868,1,0,1,2,HOOK91,1406,2/9/22
4869,2,2,1,5,WIRE31,1400,2/9/22
4870,0,5,4,9,DRAGN04,1418,2/9/22
4871,0,3,5,8,DRAGN33,1409,2/9/22
4872,0,2,1,3,PAWS21,1421,2/9/22
4873,1,1,4,6,SCARE19,1430,2/9/22
4874,1,1,4,6,PHNTM45,1433,2/9/22
4875,2,1,4,7,ETCH41,1424,2/9/22
4876,0,0,5,5,DRAGN66,1436,2/9/22
4877,0,0,0,0,,0,2/9/22
4878,1,1,4,6,SCARE16,1457,2/9/22
4879,2,3,5,10,DRAGN76,1448,2/9/22
4880,2,3,1,6,SHINR81,1503,2/9/22
4881,2,2,4,8,TORA11,1451,2/9/22
4882,3,1,2,6,WIRE31,1621,2/9/22
4883,1,2,4,7,DRAGN22,1600,2/9/22
4884,0,0,1,1,BALL91,800,2/10/22
4885,2,5,2,9,CREEP31,803,2/10/22
4886,1,5,3,9,CREEP32,803,2/10/22
4887,1,5,3,9,SCARE76,815,2/10/22
4888,1,7,8,16,COBRA01,809,2/10/22
4889,4,1,5,10,BALL02,824,2/10/22
4890,1,3,1,5,HUNG51,818,2/10/22
4891,3,3,1,7,HUNG52,821,2/10/22
4892,0,3,4,7,PAWS54,827,2/10/22
4893,1,4,0,5,EASY42,852,2/10/22
4894,0,3,1,4,PHANTOM48,833,2/10/22
4895,1,3,3,7,EPIC02,830,2/10/22
4896,0,3,5,8,EPIC09,839,2/10/22
4897,0,3,2,5,CRAZE43,836,2/10/22
4898,2,3,1,6,SMALL73,845,2/10/22
4899,2,3,4,9,PAWS46,803,2/10/22
4900,3,3,1,7,SMALL72,842,2/10/22
4901,1,4,1,6,ETCH41,848,2/10/22
4902,1,4,1,6,ETCH42,851,2/10/22
4903,1,3,3,7,COACH21,906,2/10/22
4904,1,3,1,5,COACH22,909,2/10/22
4905,2,3,3,8,SHINR81,900,2/10/22
4906,2,3,2,7,SHINR82,903,2/10/22
4907,1,5,2,8,RENO71,921,2/10/22
4908,1,5,1,7,RENO72,924,2/10/22
4909,0,1,2,3,DRAGN32,854,2/10/22
4910,1,3,3,7,AXLE11,915,2/10/22
4911,1,3,7,11,AXLE12,918,2/10/22
4912,1,4,0,5,WIRE31,927,2/10/22
4913,1,4,0,5,WIRE32,930,2/10/22
4914,0,1,1,2,HOOK46,933,2/10/22
4915,2,3,0,5,VEGA21,936,2/10/22
4916,1,3,2,6,VEGA22,939,2/10/22
4917,2,3,2,7,TORA21,945,2/10/22
4918,1,3,0,4,TORA22,948,2/10/22
4919,1,0,1,2,SPOT91,1000,2/10/22
4920,3,0,1,4,SPOT92,1003,2/10/22
4921,1,3,1,5,LOST11,951,2/10/22
4922,1,3,1,5,LOST12,954,2/10/22
4923,3,2,1,6,HOOK72,1015,2/10/22
4924,0,3,1,4,DRAGN51,1009,2/10/22
4925,0,3,3,6,DRAGN33,1006,2/10/22
4926,0,5,2,7,PAWS88,957,2/10/22
4927,1,0,0,1,DRAGN34,942,2/10/22
4928,0,3,1,4,DRAGN61,1018,2/10/22
4929,1,4,1,6,HOOK75,1012,2/10/22
4930,1,3,5,9,DRAGN66,1103,2/10/22
4931,4,3,2,9,DRAGN99,1109,2/10/22
4932,1,5,2,8,DRAGN69,1106,2/10/22
4933,4,3,5,12,DRAGN37,1112,2/10/22
4934,2,2,1,5,SMALL61,1115,2/10/22
4935,2,3,2,7,DRAGN77,1118,2/10/22
4936,1,3,1,5,ETCH41,1127,2/10/22
4937,1,3,3,7,ETCH42,1130,2/10/22
4938,1,1,4,6,CRAZE33,1133,2/10/22
4939,2,4,0,6,SMALL73,1145,2/10/22
4940,1,5,1,7,REN071,1121,2/10/22
4941,1,5,0,6,RENO72,1124,2/10/22
4942,1,4,1,6,WIRE31,1139,2/10/22
4943,3,4,1,8,WIRE32,1142,2/10/22
4944,2,3,3,8,HOOK35,1136,2/10/22
4945,2,3,3,8,HOOK35,1136,2/10/22
4946,1,0,2,3,STAB11,1154,2/10/22
4947,1,0,2,3,STAB11,1154,2/10/22
4948,1,0,3,4,COACH21,1200,2/10/22
4949,1,0,3,4,COACH21,1200,2/10/22
4950,0,0,2,2,CRAZE14,1206,2/10/22
4951,0,0,2,2,CRAZE14,1206,2/10/22
4952,1,1,7,9,EPIC06,1215,2/10/22
4953,1,1,7,9,EPIC06,1215,2/10/22
4954,2,4,6,12,COBRA01,1221,2/10/22
4955,2,4,6,12,COBRA01,1221,2/10/22
4956,2,1,4,7,BADGR01,1224,2/10/22
4957,2,1,4,7,BADGR01,1224,2/10/22
4958,0,1,5,6,CRAZE43,1209,2/10/22
4959,0,1,5,6,CRAZE43,1209,2/10/22
4960,0,1,4,5,GHOST69,1227,2/10/22
4961,0,1,4,5,GHOST69,1227,2/10/22
4962,1,0,2,3,HANG51,1236,2/10/22
4963,1,0,2,3,HANG51,1236,2/10/22
4964,1,0,4,5,HANG52,1236,2/10/22
4965,1,0,4,5,HANG52,1236,2/10/22
4966,3,1,4,8,HOOK13,1218,2/10/22
4967,3,1,4,8,HOOK13,1218,2/10/22
4968,2,2,4,8,FURY01,1242,2/10/22
4969,2,2,4,8,FURY01,1242,2/10/22
4970,1,1,1,3,SPOT91,1315,2/10/22
4971,2,1,1,4,SPOT91,1315,2/10/22
4972,2,1,1,4,SPOT91,1315,2/10/22
4973,1,2,1,4,RENO71,1400,2/10/22
4974,1,2,1,4,RENO71,1400,2/10/22
4975,1,2,4,7,RENO72,1400,2/10/22
4976,1,2,4,7,RENO72,1400,2/10/22
4977,0,1,1,2,DRAGN91,1409,2/10/22
4978,0,1,1,2,DRAGN91,1409,2/10/22
4979,1,4,2,7,SCARE03,1427,2/10/22
4980,1,4,2,7,SCARE03,1427,2/10/22
4981,4,1,0,5,CREEP31,1412,2/10/22
4982,4,1,0,5,CREEP31,1412,2/10/22
4983,1,1,1,3,CREEP32,1412,2/10/22
4984,1,1,1,3,CREEP32,1412,2/10/22
4985,1,4,1,6,VEGA21,1418,2/10/22
4986,1,4,1,6,VEGA21,1418,2/10/22
4987,1,4,2,7,VEGA22,1418,2/10/22
4988,1,4,2,7,VEGA22,1418,2/10/22
4989,3,1,2,6,SMALL71,1439,2/10/22
4990,3,1,2,6,SMALL71,1439,2/10/22
4991,0,4,3,7,PHNTM03,1433,2/10/22
4992,0,4,3,7,PHNTM03,1433,2/10/22
4993,3,1,1,5,EVIL01,1424,2/10/22
4994,3,1,1,5,EVIL01,1424,2/10/22
4995,0,2,3,5,HOOK46,1436,2/10/22
4996,0,2,3,5,HOOK46,1436,2/10/22
4997,0,2,2,4,CRAZE21,1430,2/10/22
4998,0,2,2,4,CRAZE21,1430,2/10/22
4999,2,1,5,8,DRAGN66,1445,2/10/22
5000,2,1,5,8,DRAGN66,1445,2/10/22
5001,2,1,2,5,SMALL07,1509,2/10/22
5002,2,1,2,5,SMALL07,1509,2/10/22
5003,2,3,2,7,SHINR81,1448,2/10/22
5004,2,3,2,7,SHINR81,1448,2/10/22
5005,4,3,3,10,SHINR82,1448,2/10/22
5006,4,3,3,10,SHINR82,1448,2/10/22
5007,2,1,3,6,DRAGN76,1454,2/10/22
5008,2,1,3,6,DRAGN76,1454,2/10/22
5009,1,2,4,7,CRAZE44,1457,2/10/22
5010,1,2,4,7,CRAZE44,1457,2/10/22
5011,1,1,2,4,WIRE31,1512,2/10/22
5012,2,1,3,6,WIRE32,1512,2/10/22
5013,2,1,3,6,WIRE31,1512,2/10/22
5014,2,4,1,7,DRAGN71,1500,2/10/22
5015,2,4,1,7,DRAGN71,1500,2/10/22
5016,1,1,4,6,ETCH41,1503,2/10/22
5017,1,1,4,6,ETCH41,1503,2/10/22
5018,3,1,1,5,ETCH42,1506,2/10/22
5019,3,1,1,5,ETCH42,1506,2/10/22
5020,2,1,1,4,SMALL12,1518,2/10/22
5021,2,1,1,4,SMALL12,1518,2/10/22
5022,3,1,2,6,BALL02,1530,2/10/22
5023,3,1,2,6,BALL02,1530,2/10/22
5024,0,1,4,5,DRAGN55,1606,2/10/22
5025,0,1,4,5,DRAGN55,1606,2/10/22
5026,1,3,4,8,HOOK81,1530,2/10/22
5027,1,3,4,8,HOOK81,1530,2/10/22
5028,2,1,0,3,FURY07,1800,2/10/22
5029,2,3,3,8,BALL45,1809,2/10/22
5030,2,1,1,4,BALL42,1812,2/10/22
5031,0,4,4,8,BALL35,803,2/11/22
5032,0,1,3,4,HOOK38,839,2/11/22
5033,0,2,2,4,PHNTM48,815,2/11/22
5034,1,5,7,13,COBRA,809,2/11/22
5035,2,4,4,10,PAWS46,812,2/11/22
5036,3,2,2,7,PAWS16,818,2/11/22
5037,0,2,4,6,CRAZE43,827,2/11/22
5038,0,2,4,6,EPIC02,824,2/11/22
5039,3,4,3,10,SMALL66,830,2/11/22
5040,3,2,2,7,SMALL70,836,2/11/22
5041,2,3,1,6,SMALL71,839,2/11/22
5042,1,4,1,6,GHOST69,845,2/11/22
5043,1,2,4,7,CREEP31,854,2/11/22
5044,1,2,2,5,CREEP32,854,2/11/22
5045,0,4,3,7,BALL09,851,2/11/22
5046,2,2,2,6,COACH21,900,2/11/22
5047,2,2,2,6,COACH22,900,2/11/22
5048,0,2,0,2,RHINO99,800,2/11/22
5049,1,2,4,7,FURY01,848,2/11/22
5050,1,4,3,8,BALL79,906,2/11/22
5051,1,3,3,7,PAWS88,918,2/11/22
5052,1,4,1,6,VEGA21,927,2/11/22
5053,1,4,1,6,VEGA22,927,2/11/22
5054,1,2,1,4,RECON01,939,2/11/22
5055,1,3,1,5,CRAZE54,936,2/11/22
5056,1,3,1,5,HANG51,921,2/11/22
5057,1,3,1,5,HANG52,921,2/11/22
5058,1,4,0,5,DRAGN91,942,2/11/22
5059,1,4,1,6,CRAZE79,948,2/11/22
5060,0,6,1,7,HOOK06,930,2/11/22
5061,1,3,2,6,SCARE13,951,2/11/22
5062,2,4,1,7,BUBO11,1027,2/11/22
5063,2,4,0,6,BUBO12,1027,2/11/22
5064,2,1,0,3,LOST41,1000,2/11/22
5065,1,1,0,2,LOST42,1000,2/11/22
5066,1,3,2,6,BALL36,1006,2/11/22
5067,2,1,2,5,SLOW11,1012,2/11/22
5068,2,1,1,4,SLOW12,1012,2/11/22
5069,3,1,0,4,CRAZE21,945,2/11/22
5070,1,4,2,7,LOADED01,1018,2/11/22
5071,0,1,4,5,LOADED2,1018,2/11/22
5072,2,4,1,7,HOOK46,1024,2/11/22
5073,2,3,2,7,DRAGN61,1103,2/11/22
5074,1,6,1,8,RENO71,1118,2/11/22
5075,1,6,1,8,RENO72,1118,2/11/22
5076,2,1,0,3,DRAGN63,1115,2/11/22
5077,1,1,1,3,SHINR81,1133,2/11/22
5078,1,1,1,3,SHINR 82,1133,2/11/22
5079,0,3,0,3,FURY 02,1127,2/11/22
5080,2,3,2,7,BALL 42,1130,2/11/22
5081,3,5,6,14,BALL 35,1139,2/11/22
5082,0,4,1,5,GHOST 02,1145,2/11/22
5083,1,3,4,8,ETCH 41,1148,2/11/22
5084,1,3,2,6,ETCH 42,1151,2/11/22
5085,1,5,6,12,PAWS 46,1142,2/11/22
5086,0,4,1,5,LOOT 06,1218,2/11/22
5087,3,3,2,8,LOOT 48,1221,2/11/22
5088,2,3,3,8,RECON 04,1221,2/11/22
5089,2,3,4,9,EPIC 02,1215,2/11/22
5090,0,5,2,7,EPIC 07,1206,2/11/22
5091,2,2,2,6,BALL89,1224,2/11/22
5092,0,3,1,4,CRAZE 14,1227,2/11/22
5093,1,5,4,10,COACH21,1236,2/11/22
5094,3,5,0,8,COACH22,1236,2/11/22
5095,0,2,1,3,CRAZE33,1248,2/11/22
5096,0,2,2,4,BALL61,1245,2/11/22
5097,0,3,3,6,DRAGN02,1254,2/11/22
5098,0,2,4,6,HOOK42,1257,2/11/22
5099,2,5,5,12,HOOK19,1157,2/11/22
5100,1,3,4,8,STAB11,1403,2/11/22
5101,1,3,0,4,STAB12,1406,2/11/22
5102,2,2,0,4,SMALL60,1412,2/11/22
5103,2,2,4,8,SHINR81,1415,2/11/22
5104,1,2,3,6,SHINR82,1418,2/11/22
5105,2,2,1,5,HOOK47,1506,2/11/22
5106,4,2,2,8,DRAGN61,1509,2/11/22
5107,5,2,0,7,DRAGN68,1512,2/11/22
5108,1,2,2,5,TORA11,1436,2/11/22
5109,1,2,1,4,TORA12,1439,2/11/22
5110,1,4,1,6,DRAGN72,1524,2/11/22
5111,2,5,2,9,DRAGN71,1521,2/11/22
5112,2,5,3,10,DRAGN75,1527,2/11/22
5113,2,3,1,6,GIZMO81,1442,2/11/22
5114,2,3,0,5,GIZMO82,1445,2/11/22
5115,2,2,4,8,SPECK48,1515,2/11/22
5116,3,2,0,5,LOOT03,1448,2/11/22
5117,0,3,0,3,BALL75,0,2/11/22
5118,0,6,3,9,HOOK66,1203,2/11/22
5119,3,1,2,6,LOOT55,1530,2/11/22
5120,2,5,2,9,HOOK35,1530,2/11/22
5121,0,3,1,4,BALL25,1600,2/11/22
5122,1,3,0,4,BALL29,1418,2/11/22
5123,2,1,1,4,GOLEM31,1536,2/11/22
5124,2,1,3,6,GOLEM32,1539,2/11/22
5125,1,3,2,6,BALL08,1630,2/11/22
5126,1,2,6,9,EPIC06,954,2/14/22
5127,0,2,3,5,EPIC07,948,2/14/22
5128,1,1,3,5,EPIC02,951,2/14/22
5129,2,3,1,6,SMALL54,0,2/14/22
5130,0,3,1,4,FURY07,1006,2/14/22
5131,1,1,3,5,SHINR81,1009,2/14/22
5132,1,2,3,6,RENO71,836,2/14/22
5133,1,2,2,5,RENO72,839,2/14/22
5134,1,2,0,3,STAB11,830,2/14/22
5135,3,2,2,7,STAB12,833,2/14/22
5136,4,2,2,8,COACH21,907,2/14/22
5137,4,2,2,8,COACH22,909,2/14/22
5138,1,2,4,7,SCARE19,903,2/14/22
5139,2,2,2,6,EVIL01,848,2/14/22
5140,1,1,0,2,DRAGN72,915,2/14/22
5141,1,2,3,6,SCARE12,900,2/14/22
5142,0,1,1,2,DRAGN51,857,2/14/22
5143,0,2,0,2,BALL88,851,2/14/22
5144,1,2,3,6,BALL08,854,2/14/22
5145,1,2,0,3,WIRE31,906,2/14/22
5146,2,2,1,5,WIRE32,909,2/14/22
5147,0,2,4,6,DARGN42,912,2/14/22
5148,0,2,4,6,DRAGN71,918,2/14/22
5149,2,4,3,9,DRAGN75,921,2/14/22
5150,1,2,1,4,ETCH41,927,2/14/22
5151,3,2,2,7,ETCH42,930,2/14/22
5152,2,1,3,6,DRAGN77,924,2/14/22
5153,1,1,1,3,HOOK99,933,2/14/22
5154,1,2,1,4,HANG51,939,2/14/22
5155,3,2,1,6,HANG52,939,2/14/22
5156,2,0,1,3,SMALL24,948,2/14/22
5157,2,1,2,5,HOOK32,945,2/14/22
5158,1,1,2,4,LOST11,957,2/14/22
5159,1,1,0,2,LOST12,1000,2/14/22
5160,0,2,1,3,BALL18,1006,2/14/22
5161,2,3,3,8,GOLEM11,1009,2/14/22
5162,2,3,1,6,GOLEM12,1012,2/14/22
5163,2,2,5,9,TORA11,1027,2/14/22
5164,2,1,1,4,BALL79,1002,2/14/22
5165,1,1,1,3,POST61,1015,2/14/22
5166,1,1,0,2,POST62,1018,2/14/22
5167,0,1,2,3,DRAGN47,1024,2/14/22
5168,0,1,1,2,PAWS21,1021,2/14/22
5169,0,1,1,2,DRAGN69,1130,2/14/22
5170,2,2,0,4,STAB11,1100,2/14/22
5171,1,2,1,4,STAB12,1103,2/14/22
5172,0,1,0,1,PHNTM55,1106,2/14/22
5173,1,1,0,2,DRAGN03,1109,2/14/22
5174,2,1,3,6,DRAGN21,1118,2/14/22
5175,1,1,1,3,AXEL11,1112,2/14/22
5176,1,1,2,4,AXEL12,1112,2/14/22
5177,0,1,1,2,HOOK59,1121,2/14/22
5178,0,1,6,7,DRAGN66,1136,2/14/22
5179,1,1,2,4,DRAGN61,1127,2/14/22
5180,3,1,2,6,SMALL73,1145,2/14/22
5181,1,1,2,4,PHNTM45,1133,2/14/22
5182,4,1,7,12,EPIC01,1139,2/14/22
5183,3,1,2,6,SMALL75,1151,2/14/22
5184,1,1,3,5,BALL72,1210,2/14/22
5185,0,1,4,5,Ball 56,1142,2/14/22
5186,0,1,1,2,Fury 04,1200,2/14/22
5187,0,1,1,2,Dragn 25,1157,2/14/22
5188,2,1,3,6,PHNTM 48,1204,2/14/22
5189,0,1,2,3,Fury 03,1206,2/14/22
5190,0,1,3,4,CRAZE 14,1203,2/14/22
5191,1,1,0,2,SPECK 69,1212,2/14/22
5192,1,1,4,6,STAB 11,1215,2/14/22
5193,1,1,3,5,STAB 12,1215,2/14/22
5194,3,1,2,6,COACH 21,1227,2/14/22
5195,2,1,1,4,COACH 22,1227,2/14/22
5196,5,1,1,7,BALL 21,1224,2/14/22
5197,1,1,0,2,WIRE 31,1233,2/14/22
5198,1,1,1,3,WIRE 32,1233,2/14/22
5199,1,1,1,3,SHINER 81,1242,2/14/22
5200,2,1,1,4,SHINER 82,1242,2/14/22
5201,1,1,1,3,BALL 69,1248,2/14/22
5202,0,1,1,2,BALL 88,1254,2/14/22
5203,1,1,1,3,CREEP 31,1406,2/14/22
5204,3,1,1,5,CREEP 32,1409,2/14/22
5205,3,1,1,5,SMALL 60,1412,2/14/22
5206,0,1,2,3,DRAGN 19,1415,2/14/22
5207,2,1,2,5,DRAGN 75,1418,2/14/22
5208,1,1,3,5,RENO 71,1421,2/14/22
5209,1,1,1,3,RENO 72,1424,2/14/22
5210,0,1,1,2,CRAZE 79,1442,2/14/22
5211,2,1,1,4,SMALL 67,1433,2/14/22
5212,2,1,4,7,ETCH 41,1427,2/14/22
5213,1,1,3,5,ETCH 42,1427,2/14/22
5214,0,1,2,3,PAWS 22,1451,2/14/22
5215,1,1,2,4,AXLE 11,1445,2/14/22
5216,1,1,0,2,AXLE 12,1445,2/14/22
5217,2,1,4,7,STAB 11,1457,2/14/22
5218,1,1,3,5,STAB 12,1436,2/14/22
5219,0,1,2,3,HOOK 46,1454,2/14/22
5220,2,1,2,5,SMALL 04,1500,2/14/22
5221,2,1,3,6,SMALL 10,1512,2/14/22
5222,0,2,3,5,PAWS 42,1439,2/14/22
5223,1,1,0,2,RECON 89,1503,2/14/22
5224,3,1,2,6,SMALL 57,1509,2/14/22
5225,1,3,4,8,HOOK 61,1506,2/14/22
5226,0,2,4,6,EPIC01,806,2/15/22
5227,2,2,2,6,EPIC02,803,2/15/22
5228,2,2,2,6,SMALL61,815,2/15/22
5229,3,2,2,7,SMALL60,812,2/15/22
5230,3,1,2,6,SMALL62,818,2/15/22
5231,1,3,7,11,AMMO04,809,2/15/22
5232,1,2,4,7,SCARE77,824,2/15/22
5233,0,2,1,3,PAWS16,821,2/15/22
5234,2,2,1,5,SMALL66,830,2/15/22
5235,2,2,2,6,SMALL67,833,2/15/22
5236,2,2,1,5,SMALL70,836,2/15/22
5237,2,2,5,9,FURY01,827,2/15/22
5238,1,2,4,7,COACH21,842,2/15/22
5239,1,2,1,4,AXLE11,857,2/15/22
5240,1,2,0,3,AXLE11,854,2/15/22
5241,1,2,3,6,COACH22,845,2/15/22
5242,0,2,1,3,FURY02,839,2/15/22
5243,0,2,1,3,HOOK19,800,2/15/22
5244,0,2,4,6,DRAGN37,900,2/15/22
5245,1,2,3,6,CREEP31,906,2/15/22
5246,2,2,1,5,CREEP32,909,2/15/22
5247,1,3,4,8,SCARE16,924,2/15/22
5248,4,2,2,8,RENO71,915,2/15/22
5249,1,2,1,4,RENO72,918,2/15/22
5250,1,2,0,3,WIRE31,851,2/15/22
5251,4,2,1,7,WIRE32,912,2/15/22
5252,1,2,1,4,DRAGN71,927,2/15/22
5253,2,2,4,8,CRAZE44,921,2/15/22
5254,1,2,1,4,VEGA21,936,2/15/22
5255,1,2,6,9,VEGA22,939,2/15/22
5256,0,2,4,6,Dragn83,930,2/15/22
5257,2,1,1,4,HOOK47,945,2/15/22
5258,0,2,3,5,HOOK42,942,2/15/22
5259,1,3,0,4,HANG51,948,2/15/22
5260,1,3,1,5,HANG52,951,2/15/22
5261,0,2,4,6,GIZMO21,1000,2/15/22
5262,0,2,3,5,GIZMO22,1003,2/15/22
5263,0,2,2,4,BALL25,957,2/15/22
5264,1,3,2,6,FILL21,1006,2/15/22
5265,1,3,0,4,FILL22,1009,2/15/22
5266,0,4,3,7,BALL29,954,2/15/22
5267,2,2,0,4,HOOK06,1012,2/15/22
5268,0,2,0,2,CRAZE22,1106,2/15/22
5269,3,2,1,6,BALL88,1027,2/15/22
5270,0,2,3,5,PHNTM03,1103,2/15/22
5271,1,2,2,5,PAWS33,1015,2/15/22
5272,0,2,3,5,BALL67,1030,2/15/22
5273,1,3,2,6,STAB11,1109,2/15/22
5274,1,3,1,5,STAB12,1112,2/15/22
5275,1,2,5,8,DRAGN66,1115,2/15/22
5276,1,2,0,3,DRAGN61,1121,2/15/22
5277,2,2,1,5,PHNTM45,1124,2/15/22
5278,0,2,1,3,DRAGN69,1118,2/15/22
5279,4,2,0,6,DRAGN68,1127,2/15/22
5280,1,3,2,6,CRAZE43,1151,2/15/22
5281,0,2,2,4,CRAZE45,1206,2/15/22
5282,0,2,4,6,EPIC02,1154,2/15/22
5283,1,2,5,8,EPIC06,1200,2/15/22
5284,1,2,1,4,CRAZE14,1157,2/15/22
5285,0,2,7,9,FURY03,1209,2/15/22
5286,0,2,2,4,GHOST69,1215,2/15/22
5287,3,2,2,7,SHINR81,1218,2/15/22
5288,1,2,3,6,SHINR82,1221,2/15/22
5289,4,2,3,9,LOST11,1224,2/15/22
5290,4,2,2,8,LOST12,1227,2/15/22
5291,0,3,6,9,AMMO08,1230,2/15/22
5292,1,2,4,7,COACH21,1233,2/15/22
5293,1,2,1,4,COACH22,1236,2/15/22
5294,0,1,0,1,PAWS54,1242,2/15/22
5295,0,1,1,2,RECON89,1248,2/15/22
5296,1,1,6,8,DAWG05,1239,2/15/22
5297,2,2,1,5,SMALL64,1424,2/15/22
5298,0,2,4,6,PAWS42,1418,2/15/22
5299,0,3,2,5,HOOK24,1633,2/15/22
5300,0,2,7,9,DRAGN37,1427,2/15/22
5301,2,2,4,8,STAB11,1430,2/15/22
5302,1,2,1,4,STAB12,1433,2/15/22
5303,2,3,2,7,SMALL61,1415,2/15/22
5304,0,2,4,6,DRAGN32,1421,2/15/22
5305,2,2,1,5,SMALL67,1436,2/15/22
5306,1,2,2,5,SCARE99,1439,2/15/22
5307,2,2,0,4,LOADED1,1500,2/15/22
5308,2,2,2,6,LOADED2,1503,2/15/22
5309,1,3,6,10,DRAGN66,1500,2/15/22
5310,1,1,2,4,WIRE31,1503,2/15/22
5311,1,1,2,4,WIRE32,1506,2/15/22
5312,0,0,0,0,HOOK72,1536,2/15/22
5313,0,4,2,6,LOOT51,1536,2/15/22
5314,4,4,0,8,HOOK59,1521,2/15/22
5315,2,2,2,6,HOOK33,1527,2/15/22
5316,1,2,6,9,HOOK81,1530,2/15/22
5317,2,2,2,6,TORA11,1515,2/15/22
5318,2,2,1,5,TORA12,1512,2/15/22
5319,2,5,1,8,TORA21,1545,2/15/22
5320,2,5,1,8,TORA22,1548,2/15/22
5321,0,2,0,2,PAWS21,1630,2/15/22
5322,2,2,1,5,HOOK05,1600,2/15/22
5323,2,1,0,3,TAUNT11,1442,2/15/22
5324,2,1,0,3,TAUNT12,1445,2/15/22
5325,0,2,0,2,PAWS21,1630,2/15/22
5326,1,2,1,4,DRAGN61,1818,2/15/22
5327,1,1,0,2,RECON09,1809,2/15/22
5328,1,4,1,6,HANG51,830,2/16/22
5329,0,4,4,8,FURY03,827,2/16/22
5330,1,2,5,8,EPIC06,809,2/16/22
5331,0,4,4,8,RECON77,815,2/16/22
5332,2,4,3,9,FURY04,821,2/16/22
5333,2,4,4,10,EPIC02,818,2/16/22
5334,1,4,7,12,BALL03,0,2/16/22
5335,2,3,3,8,FURY01,824,2/16/22
5336,2,4,2,8,PAWS54,842,2/16/22
5337,0,2,4,6,BALL18,848,2/16/22
5338,1,3,3,7,ETCH41,903,2/16/22
5339,4,4,2,10,RECON71,851,2/16/22
5340,2,4,2,8,SCARE36,930,2/16/22
5341,2,4,3,9,GIZMO11,857,2/16/22
5342,0,3,3,6,CRAZE45,845,2/16/22
5343,1,4,2,7,CREEP31,909,2/16/22
5344,1,4,2,7,BALL35,918,2/16/22
5345,2,4,0,6,SMALL13,0,2/16/22
5346,4,2,0,6,PHNTM45,924,2/16/22
5347,1,5,6,12,DRAGN66,927,2/16/22
5348,1,4,1,6,SCARE99,933,2/16/22
5349,1,4,2,7,LOST11,936,2/16/22
5350,1,4,0,5,LOST12,939,2/16/22
5351,3,2,2,7,LOADED1,942,2/16/22
5352,1,2,2,5,LOADED2,945,2/16/22
5353,3,4,2,9,BALL69,954,2/16/22
5354,2,4,1,7,LOOT55,948,2/16/22
5355,1,5,0,6,SLOW11,1115,2/16/22
5356,2,5,1,8,SLOW12,0,2/16/22
5357,1,5,1,7,STAB11,1121,2/16/22
5358,1,5,1,7,STAB12,1124,2/16/22
5359,1,5,1,7,HOOK28,1109,2/16/22
5360,0,4,2,6,HOOK24,1112,2/16/22
5361,0,5,2,7,DRAGN25,1133,2/16/22
5362,1,4,2,7,SCARE83,1130,2/16/22
5363,1,4,4,9,SCARE04,1127,2/16/22
5364,1,5,3,9,RENO71,1139,2/16/22
5365,1,5,2,8,RENO72,1142,2/16/22
5366,1,3,4,8,HOOK55,1136,2/16/22
5367,1,4,4,9,CRAZE66,1151,2/16/22
5368,0,0,0,0,EPIC06,0,2/16/22
5369,1,4,6,11,EPIC06,1154,2/16/22
5370,1,5,3,9,CRAZE14,1203,2/16/22
5371,1,5,3,9,AMMO04,1157,2/16/22
5372,2,5,3,10,GHOST53,1206,2/16/22
5373,2,5,2,9,SCARE99,1215,2/16/22
5374,1,5,2,8,AXLE,0,2/16/22
5375,0,5,1,6,CRAZE54,1227,2/16/22
5376,0,5,1,6,SPECK69,1218,2/16/22
5377,1,3,3,7,BALL02,1230,2/16/22
5378,2,3,2,7,DRAGN77,1230,2/16/22
5379,0,5,3,8,BALL08,1421,2/16/22
5380,1,5,1,7,COACH21,1424,2/16/22
5381,2,5,1,8,SPOT91/92,1442,2/16/22
5382,1,5,1,7,HANG51,1436,2/16/22
5383,1,3,1,5,CREEP31,1427,2/16/22
5384,1,3,2,6,CREEP32,1430,2/16/22
5385,1,4,3,8,WIRE31,1445,2/16/22
5386,1,4,4,9,WIRE32,1448,2/16/22
5387,1,5,0,6,DRAGN61,1454,2/16/22
5388,1,4,1,6,PAWS79,1503,2/16/22
5389,3,4,7,14,DRAGN66,1451,2/16/22
5390,1,4,2,7,STAR11,1512,2/16/22
5391,1,4,3,8,STAB12,1515,2/16/22
5392,1,5,4,10,SHINR81,1518,2/16/22
5393,1,5,5,11,SHINR82,1518,2/16/22
5394,2,4,2,8,PHTMN45,1530,2/16/22
5395,4,5,4,13,DRAGN71,1524,2/16/22
5396,5,3,4,12,DRAGN75,1527,2/16/22
5397,1,4,0,5,LOOT48,1600,2/16/22
5398,1,3,3,7,BALL09,1630,2/16/22
5399,2,6,3,11,ball45,1815,2/16/22
5400,1,6,2,9,BALL44,1818,2/16/22
5401,2,2,5,9,PAWS46,948,2/18/22
5402,3,8,11,22,SLOW11,1000,2/18/22
5403,3,8,1,12,SLOW12,1000,2/18/22
5404,1,2,1,4,HOOK55,1203,2/18/22
5405,0,9,0,9,RHINO99,0,2/18/22
5406,0,4,1,5,DRAGN61,1212,2/18/22
5407,1,1,2,4,HOOK46,1215,2/18/22
5408,2,3,0,5,SMALL12,1218,2/18/22
5409,3,3,1,7,SMALL31,1303,2/18/22
5410,1,4,1,6,DRAGN91,1248,2/18/22
5411,0,4,2,6,BALL28,1233,2/18/22
5412,2,3,1,6,LOOT06,1245,2/18/22
5413,1,3,0,4,COACH21,1236,2/18/22
5414,1,3,1,5,COACH22,1239,2/18/22
5415,2,4,0,6,SMALL22,1242,2/18/22
5416,0,3,1,4,AMMO04,1309,2/18/22
5417,1,4,1,6,CREEP31,1254,2/18/22
5418,1,4,0,5,CREEP32,1257,2/18/22
5419,2,4,0,6,SMALL40,1324,2/18/22
5420,1,4,2,7,CRAZE14,1300,2/18/22
5421,0,4,0,4,BALL56,1301,2/18/22
5422,0,2,0,2,SPECK21,1300,2/18/22
5423,1,1,4,6,CRAZE44,1251,2/18/22
5424,0,1,2,3,HOOK99,1305,2/18/22
5425,1,4,1,6,FILL21,1304,2/18/22
5426,1,1,1,3,FURY03,1315,2/18/22
5427,0,2,0,2,GHOST69,1312,2/18/22
5428,2,3,0,5,SMALL41,1327,2/18/22
5429,1,1,2,4,HOOK32,1307,2/18/22
5430,0,3,0,3,RECON89,1330,2/18/22
5431,0,3,0,3,RECON69,1333,2/18/22
5432,0,1,0,1,HOOK51,1345,2/18/22
5433,4,1,1,6,SLOW11,1318,2/18/22
5434,3,1,4,8,SLOW12,1321,2/18/22
5435,1,3,1,5,VEGA21,1509,2/18/22
5436,1,4,0,5,TORA31,1336,2/18/22
5437,1,1,0,2,RENO 71/72,1515,2/18/22
5438,1,1,1,3,POST 61/62,1521,2/18/22
5439,0,2,0,2,DRAGN 25,1527,2/18/22
5440,1,2,0,3,FURY07,1533,2/18/22
5441,1,1,1,3,HOOK47,1542,2/18/22
5442,2,2,2,6,DRAGN55,1548,2/18/22
5443,1,3,1,5,DRAGN61,1551,2/18/22
5444,1,1,0,2,PHNTM55,1542,2/18/22
5445,3,3,2,8,LOST11/12,1603,2/18/22
5446,0,3,3,6,BADGR09,1557,2/18/22
5447,0,0,2,2,HOOK46,1745,2/18/22
5448,0,1,2,3,HOOK51,1733,2/18/22
5449,2,8,2,12,SMALL62,818,2/22/22
5450,2,3,2,7,DRAGON38,812,2/22/22
5451,1,4,2,7,HANG51,824,2/22/22
5452,1,4,1,6,HANG51,827,2/22/22
5453,0,7,4,11,DRAGN33,821,2/22/22
5454,3,7,1,11,SCARE75,830,2/22/22
5455,2,6,7,15,POST61,842,2/22/22
5456,1,6,2,9,POST61,845,2/22/22
5457,1,6,2,9,RENO71,833,2/22/22
5458,1,6,3,10,REN72,833,2/22/22
5459,1,9,2,12,DRAGN68,854,2/22/22
5460,0,7,0,7,BALL69,857,2/22/22
5461,1,2,4,7,DRAGON77,839,2/22/22
5462,0,6,3,9,DRAGN61,851,2/22/22
5463,2,5,1,8,CREEP31,927,2/22/22
5464,1,5,0,6,CREEP31,930,2/22/22
5465,0,4,0,4,RECON88,900,2/22/22
5466,0,8,4,12,DRAGN55,906,2/22/22
5467,0,4,1,5,DRAGN91,903,2/22/22
5468,1,6,2,9,STAB11,915,2/22/22
5469,1,6,1,8,STAB12,918,2/22/22
5470,2,5,1,8,CREEP31,927,2/22/22
5471,1,5,0,6,CREEP31,930,2/22/22
5472,0,3,2,5,BALL15,936,2/22/22
5473,1,4,1,6,COACH21,939,2/22/22
5474,1,4,3,8,COACH21,942,2/22/22
5475,0,6,2,8,BADGR08,948,2/22/22
5476,2,5,1,8,CRAZE76,933,2/22/22
5477,2,4,0,6,SPECK02,951,2/22/22
5478,0,7,1,8,BALL61,945,2/22/22
5479,2,7,3,12,BALL77,954,2/22/22
5480,1,3,2,6,WIRE31,957,2/22/22
5481,1,3,1,5,WIRE32,1000,2/22/22
5482,1,6,1,8,AXEL11,1003,2/22/22
5483,1,6,3,10,AXEL12,1006,2/22/22
5484,1,4,2,7,DRAGN28,1009,2/22/22
5485,0,4,6,10,HOOK32,1018,2/22/22
5486,2,5,4,11,TORA71,1024,2/22/22
5487,1,5,4,10,TORA71,1033,2/22/22
5488,0,7,0,7,HOOK22,1012,2/22/22
5489,1,7,2,10,GOLEM11,1106,2/22/22
5490,1,7,2,10,GOLEM12,1109,2/22/22
5491,1,6,0,7,LOADED1,1015,2/22/22
5492,4,6,3,13,LOADED1,1021,2/22/22
5493,1,7,4,12,HOOK81,1118,2/22/22
5494,0,7,3,10,FURY04,1112,2/22/22
5495,0,7,3,10,FURY02,1115,2/22/22
5496,4,7,2,13,GIZMO11,1027,2/22/22
5497,4,5,1,10,GIZMO12,1032,2/22/22
5498,0,7,1,8,GHOST53,1132,2/22/22
5499,0,4,4,8,AMMO04,1127,2/22/22
5500,0,4,0,4,CRAZE45,1120,2/22/22
5501,1,4,1,6,CRAZE14,1139,2/22/22
5502,1,6,1,8,CRAZE43,1130,2/22/22
5503,2,6,2,10,SMALL 04,1200,2/22/22
5504,2,5,4,11,ETCH 41,1203,2/22/22
5505,2,5,6,13,ETCH 42,1206,2/22/22
5506,1,7,4,12,HANG51,1218,2/22/22
5507,1,7,4,12,HANG 52,1218,2/22/22
5508,2,5,5,12,TORA 11,1209,2/22/22
5509,2,5,4,11,TORA 12,1212,2/22/22
5510,0,5,0,5,DRAGN 21,1157,2/22/22
5511,1,3,8,12,AXLE 11,1227,2/22/22
5512,1,3,6,10,AXLE 12,1230,2/22/22
5513,0,6,1,7,HOOK 59,1224,2/22/22
5514,1,5,9,15,DRAGN 76,1239,2/22/22
5515,0,6,1,7,BALL 61,1239,2/22/22
5516,3,4,4,11,CRAZE 66,1248,2/22/22
5517,1,4,9,14,SPOT 91,1242,2/22/22
5518,1,4,0,5,SPOT 92,1242,2/22/22
5519,1,4,5,10,SCARE 13,1251,2/22/22
5520,1,3,2,6,DRAGN 68,1245,2/22/22
5521,1,4,1,6,STAB 11,1300,2/22/22
5522,1,4,1,6,STAB12,1300,2/22/22
5523,0,4,4,8,RECON 89,1306,2/22/22
5524,1,5,2,8,EASY 86,1310,2/22/22
5525,2,3,3,8,AMMO 02,1412,2/22/22
5526,3,2,1,6,AXLE 11,1424,2/22/22
5527,4,2,0,6,AXLE 12,1424,2/22/22
5528,0,4,4,8,PAWS 76,1415,2/22/22
5529,0,3,1,4,BADGR 08,1418,2/22/22
5530,1,4,3,8,COACH 21,1430,2/22/22
5531,1,4,0,5,COACH 22,1433,2/22/22
5532,1,5,1,7,LOST 11,1400,2/22/22
5533,1,5,0,6,LOST 12,1403,2/22/22
5534,2,3,0,5,BADGR 07,1421,2/22/22
5535,2,6,2,10,CREEP 31,1436,2/22/22
5536,1,6,3,10,CREEP 32,1439,2/22/22
5537,1,5,1,7,ETCH 41,1448,2/22/22
5538,1,5,3,9,ETCH 42,1451,2/22/22
5539,1,3,4,8,VEGA 21,1442,2/22/22
5540,2,3,3,8,VEGA 22,1445,2/22/22
5541,2,6,2,10,BALL 38,1515,2/22/22
5542,0,7,3,10,EPIC 02,1515,2/22/22
5543,1,5,3,9,GHOST 69,1506,2/22/22
5544,0,3,0,3,CRAZE 21,1506,2/22/22
5545,2,5,2,9,EPIC02,1809,2/22/22
5546,1,3,2,6,CRAZE45,1812,2/22/22
5547,1,5,2,8,GHOST53,1818,2/22/22
5548,1,2,1,4,DRAGN46,1818,2/22/22
5549,1,4,1,6,EPIC01,1830,2/22/22
5551,1,1,0,2,LOADED1,1500,2/25/22
5552,1,1,0,2,loaded12,1503,2/25/22
5553,2,3,4,9,PAWS46,1536,2/25/22
5554,0,1,3,4,HOOK38,803,2/25/22
5555,0,4,0,4,PAWS16,1539,2/25/22
5556,1,1,0,2,BALL52,1600,2/25/22
5557,0,1,0,1,LOOT48,1600,2/25/22
5558,2,2,0,4,BALL51,1557,2/25/22
5559,3,4,1,8,HOOK71,1606,2/25/22
5560,1,1,0,2,HOOK22,1515,2/25/22
5561,1,1,0,2,HOOK28,1518,2/25/22
5562,0,7,0,7,RECON03,1524,2/25/22
5563,0,7,0,7,RECON09,1521,2/25/22
5564,1,2,3,6,Reno 71,815,2/28/22
5565,1,2,4,7,Reno 72,818,2/28/22
5566,1,1,1,3,Axle 11,806,2/28/22
5567,3,1,1,5,Axle 12,809,2/28/22
5568,0,2,4,6,Hook 54,806,2/28/22
5569,0,2,4,6,Hook 55,803,2/28/22
5570,2,1,1,4,Small 73,845,2/28/22
5571,0,4,6,10,DRAGN 66,824,2/28/22
5572,2,0,2,4,DRAGN 61,821,2/28/22
5573,2,2,0,4,RHINO 99,800,2/28/22
5574,1,1,3,5,DRAGN 68,827,2/28/22
5575,2,1,4,7,DRAGN 69,830,2/28/22
5576,2,1,4,7,DRAGN 63,809,2/28/22
5577,2,1,4,7,DRAGN 22,836,2/28/22
5578,0,1,2,3,Recon 81,900,2/28/22
5579,0,1,5,6,DRAGN 34,854,2/28/22
5580,3,2,0,5,DRAGN 99,906,2/28/22
5581,2,1,1,4,Small 74,848,2/28/22
5582,1,1,2,4,Dragn 91,909,2/28/22
5583,0,3,6,9,Hook 36,851,2/28/22
5584,3,2,4,9,Dragn 38,857,2/28/22
5585,1,2,0,3,Craze 54,903,2/28/22
5586,0,1,2,3,EPIC 02,918,2/28/22
5587,0,2,1,3,PAWS 16,912,2/28/22
5588,0,1,4,5,EPIC 01,915,2/28/22
5589,0,0,3,3,CRAZE 14,924,2/28/22
5590,0,1,2,3,Craze 43,921,2/28/22
5591,0,1,3,4,Recon 77,942,2/28/22
5592,2,1,0,3,Small  24,948,2/28/22
5593,2,1,1,4,Ghost 54,945,2/28/22
5594,0,0,0,0,CRAZE 22,927,2/28/22
5595,1,1,1,3,Stab 11,951,2/28/22
5596,1,1,0,2,Stab 12,954,2/28/22
5597,1,1,1,3,Ball 11,957,2/28/22
5598,2,0,1,3,Ammo 02,1000,2/28/22
5599,2,0,0,2,Ammo 05,1003,2/28/22
5600,1,1,0,2,Hook 25,933,2/28/22
5601,2,3,4,9,PAWS 42,1024,2/28/22
5602,1,3,3,7,Loaded 1,1012,2/28/22
5603,1,3,1,5,Loaded 2,1015,2/28/22
5604,4,1,4,9,Hook 53,1027,2/28/22
5605,2,3,1,6,GIZMO 11,1030,2/28/22
5606,2,3,0,5,GIZMO 12,1033,2/28/22
5607,2,1,2,5,LOOT 03,1018,2/28/22
5608,0,1,1,2,Hook 47,1021,2/28/22
5609,1,1,3,5,BALL18,1733,2/28/22
5610,2,1,2,5,FURY,1736,2/28/22
5611,0,1,2,3,BALL64,1742,2/28/22
5612,1,1,1,3,BALL30,1757,2/28/22
5613,1,0,2,3,TAUNT11,1745,2/28/22
5614,3,1,3,7,GOLLEM11,1751,2/28/22
5615,3,1,2,6,GOLLEM12,1754,2/28/22
5616,1,1,1,3,HANG51,1800,2/28/22
5617,1,1,1,3,HANG52,1803,2/28/22
5618,0,3,5,8,COBRA01,1806,2/28/22
5619,1,3,2,6,SHINR81,1809,2/28/22
5620,1,3,1,5,SHINR82,1812,2/28/22
5621,1,0,1,2,AXLE11,1821,2/28/22
5622,3,0,0,3,AXLE12,1824,2/28/22
5623,2,0,3,5,SMALL17,1833,2/28/22
5624,1,1,2,4,RENO71,1827,2/28/22
5625,3,1,2,6,RENO72,1827,2/28/22
5626,2,0,3,5,WIRE31,1836,2/28/22
5627,1,0,8,9,WIRE32,1839,2/28/22
5628,1,0,7,8,COACH21,1815,2/28/22
5629,1,0,6,7,COACH22,1815,2/28/22
5630,4,1,3,8,DRAGN99,1851,2/28/22
5631,2,1,4,7,DRAGN68,1852,2/28/22
5632,2,1,4,7,DRAGN22,1848,2/28/22
5633,4,1,5,10,CRAZE69,1845,2/28/22
5634,2,1,1,4,DRAGN91,1854,2/28/22
5635,0,3,1,4,BALL69,1857,2/28/22
5636,0,1,8,9,DRAGN62,1921,2/28/22
5637,1,0,4,5,VEGA21,1921,2/28/22
5638,1,0,2,3,VEGA22,1921,2/28/22
5639,2,0,3,5,SLOW11,1915,2/28/22
5640,1,0,5,6,SLOW12,1918,2/28/22
5641,1,2,3,6,SPOT91,1930,2/28/22
5642,1,2,0,3,SPOT92,1933,2/28/22
5643,0,1,1,2,CRAZE21,2039,2/28/22
5644,1,0,3,4,COACH21,2106,2/28/22
5645,1,0,1,2,COACH22,2109,2/28/22
5646,0,0,2,2,PHNTM48,2103,2/28/22
5647,0,0,4,4,FURY01,2100,2/28/22
5648,1,0,2,3,STAB11,2112,2/28/22
5649,1,0,1,2,STAB12,2115,2/28/22
5650,2,1,2,5,AMMO02,2124,2/28/22
5651,1,0,2,3,CREEP31,2118,2/28/22
5652,1,0,2,3,CREEP32,2121,2/28/22
5653,2,0,1,3,SMALL20,1536,2/28/22
5654,1,1,1,3,HYDRA21,1545,2/28/22
5655,3,1,1,5,HYDRA22,1548,2/28/22
5656,2,1,1,4,SMALL17,1533,2/28/22
5657,1,3,1,5,HANG51,1551,2/28/22
5658,3,3,2,8,HANG52,1554,2/28/22
5659,0,0,2,2,EPIC02,1600,2/28/22
5660,0,1,4,5,EPIC06,1606,2/28/22
5661,1,0,5,6,EPIC01,1557,2/28/22
5662,0,1,2,3,AMMO04,1612,2/28/22
5663,1,2,1,4,GHOST53,1609,2/28/22
5664,1,1,2,4,TORA31,1145,3/1/22
5665,1,1,1,3,TORA32,1148,3/1/22
5666,1,0,0,1,VEGA21,1203,3/1/22
5667,3,0,0,3,VEGA22,1208,3/1/22
5668,3,1,1,5,GIZMO41,1148,3/1/22
5669,3,1,0,4,GIZMO42,1148,3/1/22
5670,3,0,3,6,PAWS16,1136,3/1/22
5671,2,1,0,3,LOST11,1139,3/1/22
5672,1,1,0,2,LOST12,1142,3/1/22
5673,2,1,2,5,HOOK44,1027,3/1/22
5674,1,0,1,2,GIZMO31,1030,3/1/22
5675,1,0,0,1,GIZMO32,1033,3/1/22
5676,0,1,3,4,BAL64,1209,3/1/22
5677,0,2,3,5,PAWS22,1024,3/1/22
5678,1,2,0,3,SHINR81,1215,3/1/22
5679,2,1,5,8,PAWS42,1227,3/1/22
5680,2,0,1,3,SLOW81,1018,3/1/22
5681,2,0,1,3,SLOW82,1021,3/1/22
5682,2,1,0,3,SLOW11,1012,3/1/22
5683,2,1,0,3,SLOW12,1015,3/1/22
5684,0,0,4,4,CRAZE13,1003,3/1/22
5685,2,3,2,7,GIZMO11,1006,3/1/22
5686,1,0,3,4,FURY02,957,3/1/22
5687,0,0,4,4,RECON04,951,3/1/22
5688,0,0,3,3,CRAZE45,1000,3/1/22
5689,0,0,1,1,FURY01,954,3/1/22
5690,3,0,4,7,CRAZE43,945,3/1/22
5691,2,0,2,4,EPIC02,939,3/1/22
5692,0,0,1,1,CRAZE14,948,3/1/22
5693,1,0,3,4,EPIC01,936,3/1/22
5694,0,0,0,0,SMALL15,1227,3/1/22
5695,0,0,2,2,BALL38,1224,3/1/22
5696,0,1,7,8,HOOK53,1239,3/1/22
5697,0,0,1,1,GHOST53,942,3/1/22
5698,0,0,4,4,HOOK32,927,3/1/22
5699,1,1,3,5,RECON01,1221,3/1/22
5700,1,0,2,3,SHINR81,930,3/1/22
5701,0,1,2,3,HOOK34,924,3/1/22
5702,1,2,2,5,CRAZE21,909,3/1/22
5703,0,1,1,2,HOOK91,918,3/1/22
5704,2,0,0,2,TORA11,912,3/1/22
5705,2,0,2,4,TORA12,2,3/1/22
5706,2,1,3,6,DAWG12,857,3/1/22
5707,1,1,0,2,WIRE31,1230,3/1/22
5708,1,1,2,4,WIRE32,1232,3/1/22
5709,2,0,2,4,DRAGON24,854,3/1/22
5710,2,0,1,3,GIZMO11,900,3/1/22
5711,2,0,0,2,GIZMO12,903,3/1/22
5712,2,0,3,5,DRAGON25,851,3/1/22
5713,2,0,1,3,SMALL74,848,3/1/22
5714,2,0,1,3,SMALL64,824,3/1/22
5715,1,0,3,4,DRAGON03,833,3/1/22
5716,1,0,4,5,WIRE31,839,3/1/22
5717,1,0,6,7,DRAGON66,845,3/1/22
5718,0,0,2,2,RECON77,842,3/1/22
5719,1,1,4,6,RENO71,827,3/1/22
5720,2,1,3,6,RENO72,830,3/1/22
5721,1,0,3,4,ETCH41,815,3/1/22
5722,2,1,4,7,HOOK47,821,3/1/22
5723,2,1,6,9,DRAGON53,812,3/1/22
5724,1,0,3,4,HOOK54,806,3/1/22
5725,1,1,7,9,DRAGON55,803,3/1/22
5726,1,0,5,6,LOOT51,809,3/1/22
5727,0,1,5,6,CRAZE42,800,3/1/22
5728,0,1,5,6,HOOK47,1306,3/1/22
5729,1,1,1,3,BALL68,1251,3/1/22
5730,2,1,4,7,SMALL30,1300,3/1/22
5731,4,1,3,8,GHOST48,1254,3/1/22
5732,0,2,2,4,HOOK05,1303,3/1/22
5733,2,1,7,10,DRAGON71,1309,3/1/22
5734,1,1,3,5,DRAGON62,1321,3/1/22
5735,1,1,3,5,DRAGON61,1318,3/1/22
5736,2,0,2,4,CRAZE47,1312,3/1/22
5737,1,1,7,9,DRAGON66,1327,3/1/22
5738,2,1,4,7,DRAGON76,1315,3/1/22
5739,1,0,3,4,AXLE11,1330,3/1/22
5740,3,0,1,4,AXLE12,1333,3/1/22
5741,0,1,1,2,RECON89,1324,3/1/22
5742,2,1,3,6,DRAGON25,1500,3/1/22
5743,1,0,2,3,HOOK35,1512,3/1/22
5744,1,1,6,8,SHINR81,1515,3/1/22
5745,2,1,2,5,DRAGON22,1506,3/1/22
5746,1,0,3,4,POST61,1457,3/1/22
5747,1,0,3,4,POST62,1457,3/1/22
5748,1,1,3,5,HANG51,1524,3/1/22
5749,1,1,0,2,HANG52,1527,3/1/22
5750,4,1,3,8,BADGRO1,1539,3/1/22
5751,3,1,1,5,COACH21,1533,3/1/22
5752,1,1,2,4,COAH22,1536,3/1/22
5753,1,1,2,4,BALL29,1536,3/1/22
5754,0,1,3,4,BALL15,1557,3/1/22
5755,1,1,1,3,CREEP 31,1600,3/1/22
5756,3,1,0,4,CREEP 32,1603,3/1/22
5757,0,0,5,5,EPIC 05,1606,3/1/22
5758,1,1,4,6,PAWS 13,1615,3/1/22
5759,1,1,2,4,BALL 89,1618,3/1/22
5760,2,1,1,4,SMALL 41,1627,3/1/22
5761,0,1,4,5,EPIC 02,1621,3/1/22
5762,1,1,2,4,LOOKER 01,1609,3/1/22
5763,3,1,1,5,LOOKER 02,1612,3/1/22
5764,0,1,3,4,EPIC 06,1624,3/1/22
5765,1,1,4,6,DRAGN72,800,3/2/22
5766,0,1,2,3,HOOK54,803,3/2/22
5767,2,1,2,5,STAB11,806,3/2/22
5768,2,1,5,8,STAB12,806,3/2/22
5769,0,1,5,6,CRAZE16,815,3/2/22
5770,0,0,3,3,BALL29,812,3/2/22
5771,1,0,3,4,DRAGN03,830,3/2/22
5772,1,0,2,3,WIRE31,821,3/2/22
5773,1,0,6,7,WIRE32,824,3/2/22
5774,1,0,6,7,DRAGN66,818,3/2/22
5775,0,1,5,6,HOOK17,827,3/2/22
5776,2,0,3,5,DRAGN63,848,3/2/22
5777,4,0,2,6,RECON71,830,3/2/22
5778,2,0,2,4,DRAGN33,836,3/2/22
5779,2,0,2,4,DRAGN22,842,3/2/22
5780,2,0,3,5,DRAGN21,845,3/2/22
5781,1,1,5,7,CRAZE44,839,3/2/22
5782,1,0,6,7,RENO71,854,3/2/22
5783,1,0,4,5,RENO72,854,3/2/22
5784,0,0,1,1,RECON69,903,3/2/22
5785,1,0,3,4,EPIC07,909,3/2/22
5786,0,0,3,3,CRAZE79,851,3/2/22
5787,2,1,2,5,BALL81,930,3/2/22
5788,3,0,1,4,SMALL15,927,3/2/22
5789,0,0,2,2,CRAZE14,921,3/2/22
5790,1,0,3,4,EPIC02,912,3/2/22
5791,0,0,2,2,EPIC06,915,3/2/22
5792,0,0,2,2,CRAZE43,918,3/2/22
5793,1,1,2,4,DRAGN42,906,3/2/22
5794,1,0,3,4,SCARE76,924,3/2/22
5795,2,0,2,4,CRAZE45,930,3/2/22
5796,0,1,2,3,FURY02,933,3/2/22
5797,1,0,0,1,COACH21,942,3/2/22
5798,3,0,0,3,COACH22,945,3/2/22
5799,6,1,3,10,DRAGN76,936,3/2/22
5800,0,0,2,2,BALL09,936,3/2/22
5801,2,0,1,3,AXLE11,948,3/2/22
5802,1,0,0,1,AXLE12,948,3/2/22
5803,4,0,1,5,AMMO09,954,3/2/22
5804,4,1,0,5,PAWS22,1003,3/2/22
5805,2,1,6,9,GOLEM31,1009,3/2/22
5806,2,1,6,9,GOLEM32,1012,3/2/22
5807,1,1,0,2,BUBO11,1000,3/2/22
5808,1,1,2,4,BUBO12,1003,3/2/22
5809,1,1,8,10,LOOT51,1024,3/2/22
5810,2,1,1,4,SLOW11,1030,3/2/22
5811,2,1,2,5,SLOW12,1033,3/2/22
5812,4,1,1,6,HOOK06,1018,3/2/22
5813,2,1,3,6,GIZMO21,1130,3/2/22
5814,2,1,0,3,LOST11,1136,3/2/22
5815,3,1,3,7,TORA11,1342,3/2/22
5816,3,1,3,7,TORA12,1145,3/2/22
5817,1,1,3,5,GIZMO22,1133,3/2/22
5818,2,1,0,3,LOST12,1139,3/2/22
5819,1,1,1,3,GIZMO41,1148,3/2/22
5820,1,1,0,2,GIZMO42,1151,3/2/22
5821,1,1,2,4,SCARE12,1154,3/2/22
5822,1,1,4,6,WIRE31,1157,3/2/22
5823,1,1,2,4,WIRE32,1200,3/2/22
5824,2,1,3,6,HANG51,1203,3/2/22
5825,2,1,4,7,HANG52,1206,3/2/22
5826,3,1,6,10,DRAGN72,1221,3/2/22
5827,1,1,5,7,HOOK81,1200,3/2/22
5828,1,0,7,8,RENO71,1215,3/2/22
5829,1,0,6,7,RENO72,1218,3/2/22
5830,2,1,4,7,STAB11,1209,3/2/22
5831,1,1,6,8,STAB12,1212,3/2/22
5832,0,0,2,2,CRAZE47,1227,3/2/22
5833,1,0,4,5,ETCH41,1230,3/2/22
5834,1,0,9,10,ETCH42,1236,3/2/22
5835,2,0,2,4,DRAGN03,1224,3/2/22
5836,1,0,3,4,DRAGN77,1233,3/2/22
5837,2,0,4,6,DRAGN21,1239,3/2/22
5838,2,0,3,5,DRAGN28,1251,3/2/22
5839,2,0,4,6,DRAGN22,1248,3/2/22
5840,2,0,2,4,DRAGN24,1242,3/2/22
5841,0,0,2,2,GHOST48,1245,3/2/22
5842,2,1,3,6,DRAGN91,1254,3/2/22
5843,2,0,3,5,COACH21,1303,3/2/22
5844,2,0,0,2,COACH22,1336,3/2/22
5845,0,1,3,4,DRAGN53,1315,3/2/22
5846,2,0,4,6,DRAGN76,1306,3/2/22
5847,0,1,0,1,RECON89,1300,3/2/22
5848,2,1,1,4,SMALL33,1309,3/2/22
5849,4,0,0,4,PHNTM48,1321,3/2/22
5850,4,1,5,10,DRAGN71,1312,3/2/22
5851,1,0,1,2,BALL61,1327,3/2/22
5852,4,0,2,6,RECON04,1324,3/2/22
5853,1,1,3,5,FURY02,1318,3/2/22
5854,1,0,3,4,STAB11,1454,3/2/22
5855,1,0,1,2,STAB12,1457,3/2/22
5856,2,0,2,4,AMMO01,1509,3/2/22
5857,2,1,3,6,SMALL04,1500,3/2/22
5858,2,0,1,3,RECON77,1506,3/2/22
5859,4,0,0,4,AMMO05,1512,3/2/22
5860,0,1,2,3,FURY64,1503,3/2/22
5861,1,2,0,3,BALL43,1530,3/2/22
5862,1,0,4,5,RENO71,1524,3/2/22
5863,1,0,6,7,RENO72,1527,3/2/22
5864,1,1,3,5,AXLE11,1536,3/2/22
5865,1,1,3,5,AXLE12,1539,3/2/22
5866,3,1,6,10,SPECK48,1533,3/2/22
5867,0,0,3,3,EPIC06,1545,3/2/22
5868,0,0,4,4,EPIC01,1542,3/2/22
5869,0,0,3,3,BADGR09,1548,3/2/22
5870,2,1,4,7,Hook 17,809,3/3/22
5871,1,1,5,7,HANG51,800,3/3/22
5872,1,2,5,8,STAB11,809,3/3/22
5873,1,2,2,5,STAB12,812,3/3/22
5874,1,1,1,3,CREEp 31,815,3/3/22
5875,1,1,2,4,CREEP32,818,3/3/22
5876,1,1,4,6,RENO71,821,3/3/22
5877,1,1,4,6,RENO72,824,3/3/22
5878,1,1,5,7,DRAGN66,836,3/3/22
5879,1,2,2,5,DRAGN61,830,3/3/22
5880,2,2,3,7,SMALL71,839,3/3/22
5881,3,0,1,4,SMALL72,842,3/3/22
5882,2,2,1,5,DRAGN99,851,3/3/22
5883,1,0,5,6,DRAGN62,833,3/3/22
5884,2,0,3,5,DRAGN22,848,3/3/22
5885,1,0,1,2,GOLEM31,906,3/3/22
5886,1,1,0,2,GOLEM32,909,3/3/22
5887,0,1,2,3,CRAZE79,918,3/3/22
5888,1,0,0,1,EASY42,901,3/3/22
5889,1,0,4,5,VEGA21,912,3/3/22
5890,1,0,2,3,VEGA22,915,3/3/22
5891,1,1,1,3,BALL08,903,3/3/22
5892,1,0,1,2,COBRA07,900,3/3/22
5893,2,0,3,5,SAMLL24,948,3/3/22
5894,2,0,3,5,DRAGN36,921,3/3/22
5895,1,0,0,1,DRAGN06,924,3/3/22
5896,0,0,3,3,GHOST53,932,3/3/22
5897,1,0,3,4,EPIC07,936,3/3/22
5898,3,1,5,9,EPIC01,927,3/3/22
5899,1,0,2,3,SCARE71,951,3/3/22
5900,1,0,0,1,HYDRA31,957,3/3/22
5901,3,0,0,3,HYDRA32,1000,3/3/22
5902,0,0,2,2,CRAZE14,939,3/3/22
5903,1,1,4,6,GHOST69,945,3/3/22
5904,0,1,2,3,BALL44,954,3/3/22
5905,0,1,0,1,FURY02,942,3/3/22
5906,2,0,0,2,SMALL32,1006,3/3/22
5907,0,1,3,4,BALL67,1003,3/3/22
5908,2,1,2,5,GIZMO21,1018,3/3/22
5909,1,1,1,3,GIZMO22,1021,3/3/22
5910,2,0,2,4,PAWS22,1027,3/3/22
5911,3,0,1,4,HOOK47,1024,3/3/22
5912,1,0,3,4,HOOk72,1030,3/3/22
5913,1,3,2,6,HOOK75,1033,3/3/22
5914,2,1,2,5,tora11,1130,3/3/22
5915,0,1,1,2,TORA21,1142,3/3/22
5916,2,0,2,4,TORA22,1145,3/3/22
5917,0,0,3,3,PAWS16,1136,3/3/22
5918,0,1,1,2,BALL25,1139,3/3/22
5919,1,1,0,2,GIZMO41,1148,3/3/22
5920,1,1,1,3,GIZMO42,1151,3/3/22
5921,1,1,0,2,AXLE11,1154,3/3/22
5922,1,1,1,3,AXLE11,1157,3/3/22
5923,2,1,1,4,AMMO01,1200,3/3/22
5924,1,0,1,2,EASY42,1210,3/3/22
5925,4,0,4,8,POST61,1203,3/3/22
5926,1,0,1,2,POST62,1206,3/3/22
5927,0,1,5,6,HOOK17,1214,3/3/22
5928,0,0,1,1,RECON88,1209,3/3/22
5929,1,1,2,4,SHINR81,1212,3/3/22
5930,2,1,3,6,SHINR82,1215,3/3/22
5931,2,1,3,6,PAWS33,1227,3/3/22
5932,1,1,3,5,STAB11,1236,3/3/22
5933,2,1,2,5,STAB12,1239,3/3/22
5934,1,0,4,5,CREEP31,1221,3/3/22
5935,1,0,3,4,CREEP32,1224,3/3/22
5936,1,1,2,4,RENO71,1236,3/3/22
5937,3,1,2,6,RENO72,1239,3/3/22
5938,0,1,4,5,HOOK77,1242,3/3/22
5939,0,0,0,0,HOOK03,1245,3/3/22
5940,1,0,2,3,CRAZE47,1315,3/3/22
5941,1,0,0,1,RECON02,1257,3/3/22
5942,2,0,0,2,BALL21,1254,3/3/22
5943,2,1,0,3,SMALL34,1312,3/3/22
5944,0,2,1,3,HOOK59,1303,3/3/22
5945,1,0,5,6,HANG51,1306,3/3/22
5946,1,0,6,7,HANG52,1309,3/3/22
5947,4,0,2,6,DRAGN99,1324,3/3/22
5948,0,0,5,5,DRAGN34,1333,3/3/22
5949,2,1,3,6,DRAGN91,1327,3/3/22
5950,1,0,4,5,VEGA31,1342,3/3/22
5951,4,0,2,6,VEGA32,1345,3/3/22
5952,2,3,3,8,PHNTM51,1339,3/3/22
5953,0,0,2,2,DRAGN42,1336,3/3/22
5954,1,1,3,5,SCARE19,1457,3/3/22
5955,0,0,2,2,DRAGN96,1454,3/3/22
5956,1,1,0,2,AXLE11,1515,3/3/22
5957,3,1,0,4,AXLE12,1518,3/3/22
5958,2,0,2,4,BALL57,1500,3/3/22
5959,0,0,6,6,GHOST69,1503,3/3/22
5960,2,0,0,2,BALL64,1506,3/3/22
5961,0,0,4,4,BALL61,1509,3/3/22
5962,2,0,1,3,SMALL14,1524,3/3/22
5963,2,0,3,5,SMALL13,1521,3/3/22
5964,0,1,3,4,AMMO09,1530,3/3/22
5965,2,0,2,4,AMMO02,1533,3/3/22
5966,2,0,2,4,RECON71,1527,3/3/22
5967,3,0,2,5,SMALL27,1557,3/3/22
5968,0,0,4,4,AMMO04,1600,3/3/22
5969,2,1,2,5,BALL44,1548,3/3/22
5970,1,0,3,4,EPIC06,1554,3/3/22
5971,1,1,0,2,SHINR81,1542,3/3/22
5972,1,1,4,6,SHINR82,1545,3/3/22
5973,2,3,5,10,HOOK34,842,3/4/22
5974,2,1,2,5,TORA21,809,3/4/22
5975,2,1,3,6,TORA21(2),812,3/4/22
5976,1,4,4,9,STAB11,818,3/4/22
5977,1,4,4,9,STAB11(2),821,3/4/22
5978,1,3,6,10,WIRE31,803,3/4/22
5979,1,3,4,8,WIRE31(2),806,3/4/22
5980,3,3,2,8,SMALL67,833,3/4/22
5981,2,2,4,8,DRAGN61,827,3/4/22
5982,2,2,4,8,DRAGN68,830,3/4/22
5983,1,0,4,5,DRAGN71,824,3/4/22
5984,1,3,5,9,SHINR81,845,3/4/22
5985,1,3,3,7,SHINR81(2),848,3/4/22
5986,1,3,1,5,SCARE79,900,3/4/22
5987,1,3,5,9,EPIC01,857,3/4/22
5988,1,1,2,4,EASY31,901,3/4/22
5989,0,0,1,1,RHINO99,830,3/4/22
5990,0,0,2,2,RECON81,839,3/4/22
5991,0,2,5,7,GHOST53,906,3/4/22
5992,1,3,2,6,SCARE76,903,3/4/22
5993,1,1,1,3,DRAGN05,921,3/4/22
5994,1,4,1,6,AXLE11,915,3/4/22
5995,1,4,0,5,AXLE12,918,3/4/22
5996,1,1,1,3,CRAZE21,924,3/4/22
5997,2,3,2,7,HOOK91,927,3/4/22
5998,0,2,2,4,CRAZE45,939,3/4/22
5999,0,2,1,3,EPIC02,936,3/4/22
6000,2,1,0,3,COACH21,945,3/4/22
6001,2,1,0,3,COACH22,948,3/4/22
6002,0,3,1,4,PHNTM48,942,3/4/22
6003,3,3,2,8,RENO71,951,3/4/22
6004,3,3,0,6,RENO72,954,3/4/22
6005,1,2,2,5,CREEP31,1000,3/4/22
6006,1,2,0,3,CREEP32,1003,3/4/22
6007,2,2,1,5,AMMO01,1006,3/4/22
6008,1,0,2,3,LOADED01,930,3/4/22
6009,1,0,4,5,LOADED02,933,3/4/22
6010,2,3,1,6,AMMO05,1009,3/4/22
6011,2,2,0,4,SMALL34,1012,3/4/22
6012,1,2,4,7,WIRE31,1015,3/4/22
6013,3,2,1,6,WIRE32,1018,3/4/22
6014,2,1,0,3,HOOK44,1030,3/4/22
6015,2,3,2,7,HOOK02,1033,3/4/22
6016,1,2,4,7,WIRE31,1206,3/4/22
6017,1,2,5,8,WIRE31,1206,3/4/22
6018,3,4,3,10,HOOK16,1157,3/4/22
6019,3,3,4,10,DRAGN61,1203,3/4/22
6020,1,2,5,8,DRAGN77,1212,3/4/22
6021,1,2,0,3,TORA31,1254,3/4/22
6022,1,2,6,9,TORA31,1254,3/4/22
6023,1,3,4,8,STAB11,1218,3/4/22
6024,3,3,2,8,STAB11,1221,3/4/22
6025,1,2,4,7,SHINR81,1224,3/4/22
6026,3,2,3,8,SHINR81,1227,3/4/22
6027,2,2,5,9,DRAGN62,1233,3/4/22
6028,4,4,2,10,DRAGN99,1230,3/4/22
6029,3,3,6,12,DRAGN31,1236,3/4/22
6030,3,4,3,10,RECON01,1200,3/4/22
6031,1,3,0,4,RENO71,1251,3/4/22
6032,1,3,3,7,RENO72,1254,3/4/22
6033,0,5,2,7,HOOK81,1248,3/4/22
6034,0,5,0,5,HOOK18,1245,3/4/22
6035,2,3,0,5,SMALL17,1233,3/4/22
6036,1,5,0,6,SPECK12,1324,3/4/22
6037,1,1,0,2,BALL45,1318,3/4/22
6038,0,3,0,3,HOOK69,1333,3/4/22
6039,0,3,2,5,BADGR05,1342,3/4/22
6040,2,3,3,8,AMMO02,1315,3/4/22
6041,2,1,1,4,LOST48,1345,3/4/22
6042,1,2,3,6,EASY86,1320,3/4/22
6043,2,3,2,7,SPECK11,1315,3/4/22
6044,1,2,3,6,CREEP31,1354,3/4/22
6045,1,2,2,5,CREEP31,1357,3/4/22
6046,2,2,3,7,AMMO08,1348,3/4/22
6047,0,3,2,5,BALL44,1321,3/4/22
6048,2,3,5,10,TORA11,1312,3/4/22
6049,1,2,0,3,FILL11,1151,3/4/22
6050,1,2,0,3,FILL12,1154,3/4/22
6051,0,0,1,1,HOOK41,1339,3/4/22
6052,4,2,0,6,LOOKER1,1539,3/4/22
6053,2,2,4,8,LOOKER2,1542,3/4/22
6054,2,4,2,8,PAWS13,1327,3/4/22
6055,0,4,0,4,HOOK21,1300,3/4/22
6056,2,1,2,5,BALL14,1450,3/4/22
6057,1,4,3,8,RECON02,1518,3/4/22
6058,2,2,0,4,OUZO11,1512,3/4/22
6059,2,2,1,5,OUZO12,1515,3/4/22
6060,1,1,2,4,TORA31,1524,3/4/22
6061,1,3,2,6,BALL26,1142,3/4/22
6062,0,1,0,1,CRAZE14,1527,3/4/22
6063,1,2,2,5,SCARE76,1530,3/4/22
6064,2,2,6,10,HOOK66,1530,3/4/22
6065,3,2,1,6,HOOK31,1530,3/4/22
6066,2,1,3,6,RAGTAG1,1500,3/4/22
6067,2,1,6,9,RAGTAG2,1503,3/4/22
6068,2,1,2,5,RAGTAG3,1506,3/4/22
6069,2,1,1,4,RAGTAG4,1509,3/4/22
6070,0,1,1,2,EPIC02,1533,3/4/22
6071,1,2,4,7,EPIC06,1536,3/4/22
6072,0,0,1,1,DRAGN35,1521,3/4/22
6073,0,0,1,1,DRAGN35,1521,3/4/22
6074,0,2,1,3,BALL64,1133,3/4/22
6075,3,1,2,6,BALL61,1139,3/4/22
6076,1,1,0,2,SPECK69,1145,3/4/22
6077,3,3,3,9,BALL04,1600,3/4/22
6078,1,1,1,3,TORA32,1457,3/4/22
6079,2,1,2,5,BALL42,1815,3/4/22
6080,1,0,2,3,HANG 51,903,3/7/22
6081,1,0,3,4,HANG 52,906,3/7/22
6082,0,3,2,5,PHNTM 45,909,3/7/22
6083,2,2,0,4,DRAGN 77,921,3/7/22
6084,2,2,2,6,DRAGN 61,912,3/7/22
6085,0,4,5,9,FURY 02,918,3/7/22
6086,2,2,2,6,DRAGN 68,915,3/7/22
6087,2,1,3,6,DRAGN 28,927,3/7/22
6088,3,5,0,8,DRAGN,930,3/7/22
6089,2,1,1,4,DRAGN 24,933,3/7/22
6090,2,0,0,2,DRAGN 33,936,3/7/22
6091,1,4,3,8,SHWR 81,942,3/7/22
6092,1,4,4,9,SHWR,82,3/7/22
6093,3,4,2,9,DRAGN 69,1000,3/7/22
6094,1,5,3,9,CRAZE 47,948,3/7/22
6095,3,0,0,3,DRAGN 21,924,3/7/22
6096,4,5,2,11,DRAGN 31,939,3/7/22
6097,1,4,4,9,DRAGN 71,951,3/7/22
6098,1,4,0,5,PHNTM 03,1003,3/7/22
6099,1,4,1,6,WIRE 31,954,3/7/22
6100,1,4,0,5,WIRE 32,957,3/7/22
6101,1,1,2,4,VEGA 21,1009,3/7/22
6102,0,2,0,2,VEGA 22,1012,3/7/22
6103,1,0,0,1,HYDRA 91,1015,3/7/22
6104,1,0,0,1,HYDRA 92,1018,3/7/22
6105,1,3,2,6,CRAZE 44,1021,3/7/22
6106,2,3,0,5,HOOK 99,1030,3/7/22
6107,2,0,1,3,DRAGN 18,1027,3/7/22
6108,2,2,0,4,BALL 61,1024,3/7/22
6109,3,1,1,5,AMMO 01,1039,3/7/22
6110,0,3,3,6,RECON 76,1033,3/7/22
6111,3,2,0,5,COACH 21,1109,3/7/22
6112,2,2,0,4,COACH 22,1112,3/7/22
6113,2,2,2,6,RECON 77,1048,3/7/22
6114,0,2,0,2,PAWS 76,1036,3/7/22
6115,2,2,0,4,AMMO 05,1042,3/7/22
6116,2,4,0,6,RECON 71,1045,3/7/22
6117,1,4,0,5,STAB 11,1051,3/7/22
6118,1,4,0,5,STAB 12,1054,3/7/22
6119,1,0,3,4,BALL 75,1057,3/7/22
6120,1,1,0,2,TORA 51,1103,3/7/22
6121,1,1,0,2,TORA 52,1106,3/7/22
6122,1,2,0,3,LOADED 01,1048,3/7/22
6123,1,2,4,7,LOADED 02,1051,3/7/22
6124,1,3,0,4,HOOK 75,1127,3/7/22
6125,2,2,0,4,HOOK 03,1130,3/7/22
6126,0,4,1,5,HOOK 05,1124,3/7/22
6127,1,3,1,5,TORA21,1203,3/7/22
6128,1,3,1,5,TORA22,1206,3/7/22
6129,1,2,0,3,BALL79,1145,3/7/22
6130,2,5,3,10,STAB21,1209,3/7/22
6131,2,2,0,4,BALL89,1221,3/7/22
6132,2,5,2,9,STAB22,1212,3/7/22
6133,1,2,7,10,GOLEM11,1215,3/7/22
6134,1,2,7,10,GOLEM12,1218,3/7/22
6135,0,2,3,5,HOOK61,1245,3/7/22
6136,2,3,0,5,DRAGN77,1254,3/7/22
6137,2,4,2,8,DRAGN63,1245,3/7/22
6138,1,3,5,9,DRAGN66,1248,3/7/22
6139,1,4,3,8,DRAGN68,1251,3/7/22
6140,3,3,0,6,DRAGN76,1300,3/7/22
6141,3,4,1,8,DRAGN99,1309,3/7/22
6142,1,1,5,7,DRAGN28,1306,3/7/22
6143,2,2,3,7,DRAGN31,1303,3/7/22
6144,1,4,1,6,DRAGN71,1257,3/7/22
6145,3,1,1,5,DRAGN24,1312,3/7/22
6146,1,2,1,4,SCARE11,1330,3/7/22
6147,1,3,3,7,RENO71,1321,3/7/22
6148,1,3,3,7,RENO72,1324,3/7/22
6149,0,4,1,5,HOOK81,1333,3/7/22
6150,2,3,2,7,DRAGN21,1318,3/7/22
6151,3,1,0,4,DRAGN22,1315,3/7/22
6152,2,3,0,5,DRAGN36,1327,3/7/22
6153,2,1,2,5,AXLE11,1342,3/7/22
6154,2,1,1,4,AXLE12,1342,3/7/22
6155,1,3,2,6,STAB11,1339,3/7/22
6156,1,3,1,5,STAB12,1336,3/7/22
6157,3,3,2,8,CRAZE47,1348,3/7/22
6158,1,5,2,8,WIRE31,1357,3/7/22
6159,1,3,1,5,WIRE32,1400,3/7/22
6160,1,4,1,6,PHNTM45,1409,3/7/22
6161,0,3,2,5,LOOT48,1412,3/7/22
6162,2,2,2,6,DRAGN91,1415,3/7/22
6163,2,3,1,6,SMALL04,1530,3/7/22
6164,2,4,0,6,SHINR81,1524,3/7/22
6165,2,4,0,6,SHINR82,1527,3/7/22
6166,1,1,2,4,BALL42,1533,3/7/22
6167,3,2,11,16,TAUNT41,1539,3/7/22
6168,4,2,2,8,TAUNT42,1542,3/7/22
6169,1,1,1,3,AMMO02,1545,3/7/22
6170,0,2,4,6,BALL04,1545,3/7/22
6171,0,1,1,2,EPIC02,1606,3/7/22
6172,2,1,2,5,SMALL27,1557,3/7/22
6173,2,0,1,3,SMALL31,1603,3/7/22
6174,0,1,0,1,CRAZE14,1600,3/7/22
6175,2,0,2,4,COBRA01,1609,3/7/22
6176,0,1,3,4,EPIC01,1612,3/7/22
6177,1,1,3,5,CREEP31,1615,3/7/22
6178,1,1,4,6,CREEP32,1618,3/7/22
6179,2,2,1,5,RECON71,1621,3/7/22
6180,2,0,2,4,AMMO01,1624,3/7/22
6181,2,3,2,7,PAWS42,1630,3/7/22
6182,1,0,1,2,Hang51,1632,3/7/22
6183,2,2,2,6,Ball56,1842,3/7/22
6184,2,1,1,4,PAWS34,1851,3/7/22
6185,1,0,3,4,Ghost02,1854,3/7/22
6186,2,1,2,5,Hook53,1900,3/7/22
6187,1,0,3,4,cobra01,1848,3/7/22
6188,1,1,2,4,Dragn02,1903,3/7/22
6189,1,1,2,4,Epic01,1835,3/7/22
6190,1,1,3,5,DRAGN54,1857,3/7/22
6191,1,4,3,8,DRAGN61,800,3/8/22
6192,1,1,6,8,DRAGN66,803,3/8/22
6193,1,3,4,8,HANG51,806,3/8/22
6194,3,3,3,9,HANG51,806,3/8/22
6195,1,4,3,8,DRAGN71,815,3/8/22
6196,3,4,1,8,SMALL62,818,3/8/22
6197,0,4,5,9,PHNTM45,812,3/8/22
6198,3,4,2,9,DRAGN21,824,3/8/22
6199,2,4,3,9,CRAZE47,821,3/8/22
6200,2,6,4,12,DRAGN33,825,3/8/22
6201,1,4,5,10,TORA31,839,3/8/22
6202,1,4,5,10,TORA32,839,3/8/22
6203,2,1,6,9,DRAGN28,845,3/8/22
6204,2,4,3,9,DRAGN34,848,3/8/22
6205,1,2,5,8,SCARE77,845,3/8/22
6206,2,4,4,10,SMALL76,854,3/8/22
6207,2,4,1,7,DRAGN99,909,3/8/22
6208,1,4,0,5,SHINR81,900,3/8/22
6209,1,4,3,8,SHINR81,900,3/8/22
6210,0,1,3,4,HOOK19,906,3/8/22
6211,0,5,4,9,BALL81,915,3/8/22
6212,0,2,1,3,RECON08,912,3/8/22
6213,2,1,4,7,WIRE31,918,3/8/22
6214,1,1,3,5,WIRE31,921,3/8/22
6215,3,1,2,6,SMALL21,939,3/8/22
6216,1,1,4,6,AXLE11,924,3/8/22
6217,1,1,3,5,AXLE12,927,3/8/22
6218,2,1,3,6,EPIC01,945,3/8/22
6219,0,1,6,7,FURY02,936,3/8/22
6220,1,2,4,7,BALL67,933,3/8/22
6221,1,2,3,6,SCARE76,951,3/8/22
6222,0,4,2,6,GHOST53,954,3/8/22
6223,2,3,3,8,AMMO08,957,3/8/22
6224,2,2,0,4,AMMO01,1003,3/8/22
6225,0,2,2,4,EPIC02,948,3/8/22
6226,2,2,0,4,CRAZE76,1000,3/8/22
6227,1,3,0,4,COACH21,1015,3/8/22
6228,1,3,0,4,COACH21,1018,3/8/22
6229,0,2,4,6,HOOK47,1024,3/8/22
6230,0,5,2,7,BALL25,1012,3/8/22
6231,2,3,3,8,HOOK75,1030,3/8/22
6232,1,1,0,2,LOST11,1100,3/8/22
6233,1,1,0,2,LOST12,1103,3/8/22
6234,1,3,1,5,HYDRA91,1118,3/8/22
6235,2,3,0,5,HYDRA91,1121,3/8/22
6236,2,4,1,7,HOOK77,1033,3/8/22
6237,4,3,3,10,GOLEM21,1112,3/8/22
6238,4,3,5,12,GOLEM21,1115,3/8/22
6239,2,2,4,8,DRAGN61,1133,3/8/22
6240,2,1,3,6,SMALL71,1139,3/8/22
6241,2,3,2,7,PHNTM45,1136,3/8/22
6242,0,2,0,2,GHOST69,1142,3/8/22
6243,2,3,1,6,SCARE71,1151,3/8/22
6244,0,3,2,5,DRAGN33,1157,3/8/22
6245,2,3,4,9,DRAGN72,1148,3/8/22
6246,2,3,4,9,DRAGN21,1154,3/8/22
6247,2,3,3,8,CRAZE47,1145,3/8/22
6248,2,2,1,5,DRAGN17,1221,3/8/22
6249,1,3,6,10,GOLEM31,1209,3/8/22
6250,1,3,3,7,GOLEM31,1209,3/8/22
6251,2,1,3,6,CRAZY69,1200,3/8/22
6252,2,5,4,11,DRAGN32,1215,3/8/22
6253,3,2,3,8,DRAGN31,1218,3/8/22
6254,1,2,1,4,WIRE31,1224,3/8/22
6255,2,2,4,8,PAWS42,1230,3/8/22
6256,0,3,3,6,SHINR81,1236,3/8/22
6257,0,3,3,6,SHINR82,1236,3/8/22
6258,3,3,0,6,SMALL22,1242,3/8/22
6259,3,3,3,9,SMALL23,1242,3/8/22
6260,0,3,7,10,HOOK53,1233,3/8/22
6261,1,3,2,6,AXLE11,1248,3/8/22
6262,1,3,1,5,AXLE12,1248,3/8/22
6263,1,3,5,9,DRAGN03,1254,3/8/22
6264,1,0,6,7,STAB11,1257,3/8/22
6265,1,0,4,5,STAB12,1257,3/8/22
6266,2,4,4,10,HYDRA11,1312,3/8/22
6267,2,4,6,12,HYDRA12,1312,3/8/22
6268,2,4,5,11,HYDRA13,1312,3/8/22
6269,2,4,4,10,HYDRA14,1312,3/8/22
6270,1,1,3,5,VEGA21,1306,3/8/22
6271,1,1,4,6,VEGA22,1306,3/8/22
6272,1,3,2,6,CRAZE14,1303,3/8/22
6273,2,2,1,5,SMALL24,1248,3/8/22
6274,1,1,1,3,EASY86,1345,3/8/22
6275,0,3,5,8,FURY01,1418,3/8/22
6276,1,1,3,5,EPIC06,1424,3/8/22
6277,1,0,4,5,SPOT91,1430,3/8/22
6278,3,1,6,10,SPOT92,1430,3/8/22
6279,1,3,4,8,FURY02,1421,3/8/22
6280,0,1,2,3,CRAZE43,1439,3/8/22
6281,0,2,5,7,BALL25,1436,3/8/22
6282,0,3,4,7,EPIC02,1436,3/8/22
6283,1,5,0,6,OUZO11,1533,3/8/22
6284,1,5,1,7,OUZO12,1533,3/8/22
6285,1,5,1,7,TORA11,1524,3/8/22
6286,1,5,2,8,TORA12,1524,3/8/22
6287,2,1,2,5,HOOK53,1836,3/8/22
6288,1,3,1,5,PAWS42,1839,3/8/22
6289,2,3,1,6,LOOT48,1842,3/8/22
6290,2,2,0,4,BALL75,1854,3/8/22
6291,1,1,3,5,COBRA01,1848,3/8/22
6292,1,1,3,5,CRAZE79,1845,3/8/22
6293,2,6,1,9,SPECK02,1851,3/8/22
6294,1,2,3,6,Phantm 45,809,3/9/22
6295,1,2,2,5,Stab 11,800,3/9/22
6296,1,2,5,8,Stab 12,803,3/9/22
6297,2,2,4,8,DRAGN 33,824,3/9/22
6298,2,1,3,6,DRAGN 21,821,3/9/22
6299,4,2,5,11,DRAGN 31,842,3/9/22
6300,1,2,4,7,SLOW  41,830,3/9/22
6301,1,2,1,4,SLOW 42,830,3/9/22
6302,0,2,1,3,RENO 71,0,3/9/22
6303,0,2,4,6,RENO 72,851,3/9/22
6304,1,1,4,6,LOOT 51,848,3/9/22
6305,1,2,3,6,DRAGN28,827,3/9/22
6306,2,2,3,7,CREEP 31,900,3/9/22
6307,1,2,3,6,CREEP 32,903,3/9/22
6308,0,2,1,3,PAWS 21,857,3/9/22
6309,1,2,3,6,AXLE 11,906,3/9/22
6310,1,2,4,7,AXLE 12,909,3/9/22
6311,0,2,2,4,HOOK 91,912,3/9/22
6312,0,2,1,3,RECON 76,924,3/9/22
6313,0,2,5,7,FURY 01,921,3/9/22
6314,1,2,2,5,WIRE 31,915,3/9/22
6315,3,2,2,7,WIRE 32,918,3/9/22
6316,0,2,1,3,RECON 81,927,3/9/22
6317,0,2,2,4,EPIC 01,939,3/9/22
6318,2,2,2,6,BALL 64,930,3/9/22
6319,1,2,4,7,PAWS 43,936,3/9/22
6320,2,2,4,8,EPIC 01,948,3/9/22
6321,0,1,6,7,BALL 14,942,3/9/22
6322,2,1,0,3,CRAZE 76,954,3/9/22
6323,2,1,1,4,AMMO 05,951,3/9/22
6324,2,1,0,3,COACH 21,1006,3/9/22
6325,2,1,2,5,COACH 22,1009,3/9/22
6326,0,1,0,1,PHNTM 48,1003,3/9/22
6327,1,1,3,5,DRAGN 75,957,3/9/22
6328,1,2,2,5,LOOT 06,930,3/9/22
6329,3,1,1,5,GIZMO 21,1100,3/9/22
6330,1,1,2,4,GIZMO 22,1100,3/9/22
6331,1,1,2,4,TORA 11,1118,3/9/22
6332,1,1,4,6,TORA 12,1121,3/9/22
6333,1,3,0,4,SLOW 11,1106,3/9/22
6334,1,3,2,6,SLOW 12,1109,3/9/22
6335,2,3,1,6,BALL 88,1124,3/9/22
6336,3,1,6,10,GOLEM 11,1037,3/9/22
6337,3,1,2,6,GOLEM 12,1136,3/9/22
6338,1,0,1,2,HANG 51,1135,3/9/22
6339,1,0,0,1,HANG 52,1139,3/9/22
6340,1,1,2,4,DRAGN 68,1145,3/9/22
6341,0,1,6,7,DRAGN61,1148,3/9/22
6342,1,1,1,3,STAB11,0,3/9/22
6343,3,1,0,4,STAB12,0,3/9/22
6344,2,1,2,5,SMALL76,0,3/9/22
6345,3,1,1,5,CRAZE44,0,3/9/22
6346,2,1,3,6,CRAZE33,0,3/9/22
6347,2,0,1,3,DRAGN21,0,3/9/22
6348,2,1,3,6,DRAGN22,0,3/9/22
6349,3,1,4,8,DRAGN02,0,3/9/22
6350,2,1,3,6,DRAGN28,0,3/9/22
6351,2,1,1,4,CRAZE79,0,3/9/22
6352,2,1,5,8,DRAGN33,0,3/9/22
6353,1,1,5,7,ETCH41,0,3/9/22
6354,2,1,2,5,ETCH42,0,3/9/22
6355,2,1,0,3,HOOK99,0,3/9/22
6356,1,1,1,3,SHINR81,0,3/9/22
6357,1,1,6,8,SHINR82,0,3/9/22
6358,0,1,1,2,RENO71,0,3/9/22
6359,2,1,1,4,RENO72,0,3/9/22
6360,2,3,3,8,AXLE11,0,3/9/22
6361,2,3,6,11,AXLE12,0,3/9/22
6362,1,1,6,8,WIRE31,0,3/9/22
6363,3,1,1,5,WIRE32,0,3/9/22
6364,2,3,5,10,RECON76,0,3/9/22
6365,1,1,0,2,DRAGN18,0,3/9/22
6366,0,1,1,2,RECON77,0,3/9/22
6367,1,1,1,3,VEGA21,0,3/9/22
6368,1,1,1,3,VEGA22,0,3/9/22
6369,1,1,0,2,BALL04,0,3/9/22
6370,1,1,1,3,EASY42,0,3/9/22
6371,2,1,2,5,CRAZE21,0,3/9/22
6372,2,1,5,8,DRAGN91,0,3/9/22
6373,1,1,1,3,SCARE71,0,3/9/22
6374,0,1,0,1,CRAZE14,0,3/9/22
6375,2,1,1,4,AMMO01,0,3/9/22
6376,2,1,3,6,AMMO02,0,3/9/22
6377,3,3,1,7,BALL02,0,3/9/22
6378,1,3,2,6,COACH21,0,3/9/22
6379,1,3,4,8,COACH22,0,3/9/22
6380,2,3,4,9,LOOT48,0,3/9/22
6381,2,1,4,7,BALL38,0,3/9/22
6382,1,1,3,5,STAB11,0,3/9/22
6383,1,1,1,3,STAB12,0,3/9/22
6384,2,1,2,5,GIZMO31,0,3/9/22
6385,2,1,0,3,GIZMO32,0,3/9/22
6386,6,1,4,11,HOOK53,0,3/9/22
6387,0,1,1,2,GHOST53,0,3/9/22
6388,0,1,3,4,HOOK54,0,3/9/22
6389,4,1,6,11,SPECK48,0,3/9/22
6390,0,1,2,3,HOOK37,0,3/9/22
6391,2,1,0,3,TORA21,0,3/9/22
6392,2,1,1,4,TORA22,0,3/9/22
6393,2,1,1,4,HOOK71,1630,3/9/22
6394,2,1,1,4,HOOK71,1630,3/9/22
6395,0,1,1,2,HOOK72,1630,3/9/22
6396,0,1,1,2,HOOK72,1630,3/9/22
6397,0,1,5,6,HOOK21,1415,3/9/22
6398,0,1,5,6,HOOK21,1415,3/9/22
6399,2,1,2,5,TAUNT51,1548,3/9/22
6400,2,1,1,4,PAWS34,1833,3/9/22
6401,1,1,3,5,DRAGN72,1845,3/9/22
6402,1,5,5,11,PHANTM45,739,3/10/22
6403,1,5,4,10,DRAGN77,742,3/10/22
6404,0,6,3,9,DRAGN61,736,3/10/22
6405,2,5,5,12,DRAGN33,745,3/10/22
6406,1,4,7,12,DRAGN22,748,3/10/22
6407,2,6,4,12,DRAGN31,751,3/10/22
6408,1,4,6,11,AXLE11,803,3/10/22
6409,1,5,4,10,SCARE76,821,3/10/22
6410,1,4,0,5,RHINO99,0,3/10/22
6411,0,5,1,6,LOOT48,815,3/10/22
6412,0,5,5,10,FURY03,818,3/10/22
6413,2,6,6,14,DRAGN19,833,3/10/22
6414,1,3,2,6,CRAZE54,827,3/10/22
6415,1,8,0,9,RECON01,824,3/10/22
6416,0,5,4,9,GHOST53,839,3/10/22
6417,1,6,1,8,CRAZE21,830,3/10/22
6418,2,4,6,12,FURY01,848,3/10/22
6419,2,2,0,4,CRAZE76,851,3/10/22
6420,1,5,4,10,PAWS43,845,3/10/22
6421,1,4,2,7,DRAGN06,842,3/10/22
6422,1,6,3,10,HOOK16,924,3/10/22
6423,2,6,0,8,LOST11,915,3/10/22
6424,1,6,0,7,LOST12,918,3/10/22
6425,1,5,2,8,CRAZE47,921,3/10/22
6426,2,4,3,9,GIZMO11,1036,3/10/22
6427,2,4,3,9,GIZMO12,1042,3/10/22
6428,1,6,1,8,BALL38,1039,3/10/22
6429,0,5,0,5,BALL88,1112,3/10/22
6430,0,4,2,6,DAWG05,1100,3/10/22
6431,1,4,3,8,DAWG02,1406,3/10/22
6432,0,3,3,6,DAWG41,1409,3/10/22
6433,4,5,8,17,shinr81,1421,3/11/22
6434,2,4,3,9,axle11,1430,3/11/22
6435,3,4,8,15,hook48,1427,3/11/22
6436,2,2,4,8,stab11,1436,3/11/22
6437,1,2,1,4,dragn18,1442,3/11/22
6438,2,3,3,8,wire31,1415,3/11/22
6439,1,3,2,6,wire32,1418,3/11/22
6440,1,5,5,11,ETCH41,1609,3/11/22
6441,3,5,2,10,ETCH42,1612,3/11/22
6442,0,5,3,8,BALL31,1606,3/11/22
6443,1,3,1,5,CREEP31,1600,3/11/22
6444,1,3,1,5,CREEP32,1603,3/11/22
6445,1,4,0,5,VEGA21,1615,3/11/22
6446,1,4,1,6,VEGA22,1618,3/11/22
6447,1,4,5,10,POST61,1621,3/11/22
6448,1,4,1,6,POST62,1624,3/11/22
6449,1,4,3,8,SCARE76,1633,3/11/22
6450,1,4,2,7,SCARE75,1636,3/11/22
6451,1,4,0,5,SCARE71,1639,3/11/22
6452,2,4,3,9,GOLEM21,1627,3/11/22
6453,2,4,3,9,GOLEM22,1630,3/11/22
6454,1,3,1,5,CRAZE14,1830,3/11/22
6455,0,4,1,5,EPIC02,1836,3/11/22
6456,2,2,2,6,RECON77,1845,3/11/22
6457,3,4,0,7,RECON09,1842,3/11/22
6458,1,4,1,6,AXLE11,1848,3/11/22
6459,1,4,1,6,AXEL11,1848,3/11/22
6460,2,4,2,8,AMMO05,2045,3/11/22
6461,2,1,6,9,DRAGN32,821,3/14/22
6462,1,2,3,6,AXLE11,806,3/14/22
6463,1,2,7,10,AXLE12,809,3/14/22
6464,1,2,7,10,RENO71,812,3/14/22
6465,1,1,6,8,RENO72,815,3/14/22
6466,0,1,1,2,DRAGN61,818,3/14/22
6467,0,1,3,4,RHINO99,800,3/14/22
6468,0,4,5,9,BALL56,836,3/14/22
6469,0,2,4,6,EPIC02,848,3/14/22
6470,0,1,2,3,LOOT48,833,3/14/22
6471,2,2,2,6,BALL61,824,3/14/22
6472,0,1,4,5,PAWS43,842,3/14/22
6473,1,2,1,4,RECON01,912,3/14/22
6474,3,2,2,7,LOST11,851,3/14/22
6475,1,2,1,4,LOST12,854,3/14/22
6476,1,2,1,4,CRAZE54,909,3/14/22
6477,1,2,2,5,DRAGN91,915,3/14/22
6478,1,1,2,4,WIRE31,857,3/14/22
6479,1,1,1,3,WIRE32,900,3/14/22
6480,0,1,3,4,CRAZE25,903,3/14/22
6481,1,1,2,4,DRAGN69,918,3/14/22
6482,1,2,3,6,HANG51,927,3/14/22
6483,2,2,2,6,HANG51,930,3/14/22
6484,2,1,1,4,SMALL23,945,3/14/22
6485,0,2,4,6,HOOK06,939,3/14/22
6486,0,2,2,4,HOOK47,942,3/14/22
6487,0,1,0,1,BADGR03,951,3/14/22
6488,1,0,3,4,DRAGN28,957,3/14/22
6489,2,1,3,6,DRAGN36,948,3/14/22
6490,0,1,4,5,HOOK54,933,3/14/22
6491,1,1,0,2,CRAZE44,1006,3/14/22
6492,2,1,1,4,DRAGN75,1006,3/14/22
6493,1,2,3,6,GIZMO21,1012,3/14/22
6494,1,2,1,4,GIZMO22,1015,3/14/22
6495,2,1,0,3,LOST21,1018,3/14/22
6496,2,1,0,3,LOST21,1021,3/14/22
6497,1,2,4,7,TORA11,1024,3/14/22
6498,1,2,8,11,TORA11,1027,3/14/22
6499,1,3,0,4,FILL11,1009,3/14/22
6500,3,3,0,6,FILL11,1009,3/14/22
6501,1,2,2,5,MANLY21,1030,3/14/22
6502,1,2,3,6,MANLY22,1033,3/14/22
6503,1,2,1,4,TORA31,1118,3/14/22
6504,1,2,1,4,TORA31,1118,3/14/22
6505,2,2,1,5,TAUNT11,1112,3/14/22
6506,2,2,2,6,TAUNT11,1115,3/14/22
6507,1,1,7,9,FILL21,1106,3/14/22
6508,2,1,4,7,FILL12,1109,3/14/22
6509,2,2,1,5,GOLEM31,1124,3/14/22
6510,2,2,1,5,GOLEM31,1127,3/14/22
6511,1,2,2,5,GIZMO11,1130,3/14/22
6512,1,2,4,7,GIZMO11,1133,3/14/22
6513,2,2,4,8,GIZMO51,1136,3/14/22
6514,2,2,1,5,GIZMO51,1139,3/14/22
6515,1,1,3,5,DRAGN66,1148,3/14/22
6516,1,1,1,3,PHNTM45,1142,3/14/22
6517,1,1,1,3,DRAGN91,1154,3/14/22
6518,0,1,3,4,DRAGN61,1151,3/14/22
6519,0,1,1,2,HOOK62,1145,3/14/22
6520,0,2,8,10,LOOT50,1206,3/14/22
6521,1,1,2,4,VEGA21,1200,3/14/22
6522,1,1,3,5,VEGA21,1203,3/14/22
6523,3,3,2,8,FILL21,1406,3/14/22
6524,2,2,7,11,COBRA01,1215,3/14/22
6525,1,1,4,6,POST61,1209,3/14/22
6526,2,1,3,6,POST61,1212,3/14/22
6527,0,1,2,3,SPECK69,1218,3/14/22
6528,0,2,5,7,GHOST53,1233,3/14/22
6529,0,1,3,4,CRAZE66,1221,3/14/22
6530,0,2,2,4,CRAZE43,1230,3/14/22
6531,0,3,5,8,EPIC02,1227,3/14/22
6532,1,2,3,6,COACH21,1245,3/14/22
6533,1,2,0,3,COACH21,1248,3/14/22
6534,2,3,4,9,AMMO08,1300,3/14/22
6535,1,2,2,5,LOST11,1251,3/14/22
6536,1,2,1,4,LOST12,1254,3/14/22
6537,2,2,1,5,CRAZE25,1257,3/14/22
6538,2,2,2,6,HANG51,1303,3/14/22
6539,2,2,2,6,HANG52,1306,3/14/22
6540,1,2,4,7,DRAGN62,1445,3/14/22
6541,3,2,3,8,DRAGN47,1448,3/14/22
6542,1,4,5,10,DRAGN83,1509,3/14/22
6543,1,2,3,6,DRAGN91,1503,3/14/22
6544,2,3,3,8,DRAGN36,1457,3/14/22
6545,0,2,2,4,BALL71,1500,3/14/22
6546,1,5,5,11,ETCH41,1451,3/14/22
6547,2,5,5,12,ETCH41,1454,3/14/22
6548,0,2,0,2,DRAGN33,1503,3/14/22
6549,0,3,0,3,HOOK77,1521,3/14/22
6550,1,4,4,9,DRAGN03,1524,3/14/22
6551,0,2,4,6,DRAGN66,1530,3/14/22
6552,0,1,1,2,DRAGN69,1536,3/14/22
6553,1,2,6,9,AXLE11,800,3/15/22
6554,1,2,5,8,AXLE12,800,3/15/22
6555,1,2,4,7,BALL56,842,3/15/22
6556,1,1,4,6,RENO71,806,3/15/22
6557,3,1,2,6,RENO72,806,3/15/22
6558,3,1,0,4,AMMO05,903,3/15/22
6559,0,2,5,7,GHOST69,815,3/15/22
6560,0,2,3,5,FURY03,818,3/15/22
6561,0,2,4,6,BALL89,824,3/15/22
6562,0,1,2,3,HOOK61,812,3/15/22
6563,0,1,4,5,CRAZE43,827,3/15/22
6564,0,1,2,3,GHOST53,833,3/15/22
6565,1,2,2,5,SCARE74,836,3/15/22
6566,2,3,4,9,BALL51,830,3/15/22
6567,1,2,0,3,VEGA21,839,3/15/22
6568,1,2,0,3,VEGA22,851,3/15/22
6569,2,1,5,8,COACH21,848,3/15/22
6570,2,1,0,3,COACH22,851,3/15/22
6571,2,1,2,5,SHINR81,854,3/15/22
6572,2,1,3,6,SHINR82,857,3/15/22
6573,2,2,3,7,AMMO08,906,3/15/22
6574,1,4,0,5,ETCH41,909,3/15/22
6575,1,4,0,5,ETCH42,912,3/15/22
6576,0,1,1,2,DRAGN69,930,3/15/22
6577,1,0,6,7,POST61,915,3/15/22
6578,1,0,0,1,POST62,918,3/15/22
6579,1,1,2,4,WIRE31,924,3/15/22
6580,3,1,0,4,WIRE32,927,3/15/22
6581,1,3,2,6,HANG51,933,3/15/22
6582,3,3,1,7,HANG52,936,3/15/22
6583,1,3,1,5,STAB11,939,3/15/22
6584,1,3,4,8,STAB12,942,3/15/22
6585,2,1,2,5,SMALL27,957,3/15/22
6586,1,2,0,3,SPOT91,945,3/15/22
6587,1,2,0,3,SPOT92,948,3/15/22
6588,2,3,3,8,DRAGN36,954,3/15/22
6589,1,1,2,4,DRAGN03,1009,3/15/22
6590,1,2,0,3,DRAGN33,1006,3/15/22
6591,1,2,3,6,CRAZE69,1000,3/15/22
6592,3,1,2,6,DRAGN21,1003,3/15/22
6593,2,1,1,4,CRAZE79,951,3/15/22
6594,1,4,1,6,CRAZE44,1012,3/15/22
6595,4,2,3,9,DUKE16,1015,3/15/22
6596,1,2,1,4,BADGR05,1021,3/15/22
6597,1,3,2,6,TORA11,1024,3/15/22
6598,1,3,6,10,TORA12,1027,3/15/22
6599,1,3,4,8,TAUNT11,1030,3/15/22
6600,1,3,1,5,TAUNT12,1033,3/15/22
6601,1,3,4,8,TAUNT31,1100,3/15/22
6602,1,3,3,7,TAUNT32,1103,3/15/22
6603,1,1,1,3,MANLY31,1106,3/15/22
6604,2,1,1,4,MANLY32,1109,3/15/22
6605,1,0,3,4,TORA21,1112,3/15/22
6606,1,0,2,3,TORA22,1115,3/15/22
6607,1,2,1,4,GIZMO51,1130,3/15/22
6608,1,2,3,6,GIZMO52,1133,3/15/22
6609,1,1,3,5,GOLEM41,1118,3/15/22
6610,1,1,4,6,GOLEM42,1121,3/15/22
6611,0,1,4,5,HOOK75,1124,3/15/22
6612,1,1,0,2,DRAGN81,1136,3/15/22
6613,1,0,2,3,PHNTM45,1139,3/15/22
6614,1,0,5,6,DRAGN66,1145,3/15/22
6615,0,0,2,2,DRAGN61,1142,3/15/22
6616,1,2,1,4,DRAGN02,1148,3/15/22
6617,1,2,5,8,CREEP31,1157,3/15/22
6618,3,2,0,5,CREEP32,1200,3/15/22
6619,2,0,3,5,SMALL07,1209,3/15/22
6620,1,1,2,4,SCARE69,1224,3/15/22
6621,0,1,9,10,BALL89,1206,3/15/22
6622,1,0,6,7,POST61,1212,3/15/22
6623,1,0,2,3,POST62,1215,3/15/22
6624,2,1,2,5,WIRE31,1218,3/15/22
6625,2,1,2,5,WIRE32,1221,3/15/22
6626,0,0,4,4,CRAZE43,1233,3/15/22
6627,4,0,4,8,SMALL15,1227,3/15/22
6628,1,1,1,3,CRAZE14,1230,3/15/22
6629,0,1,3,4,BALL23,1236,3/15/22
6630,2,0,1,3,SMALL24,1248,3/15/22
6631,3,1,1,5,BALL02,1239,3/15/22
6632,1,2,4,7,SHINR81,1300,3/15/22
6633,3,2,1,6,SHINR82,1303,3/15/22
6634,4,0,4,8,BALL19,1257,3/15/22
6635,3,1,5,9,AMMO08,1254,3/15/22
6636,2,1,1,4,BALL61,1315,3/15/22
6637,1,1,2,4,RECON81,1318,3/15/22
6638,1,0,2,3,HANG51,1436,3/15/22
6639,1,0,5,6,HANG52,1439,3/15/22
6640,2,0,1,3,STAB11,1442,3/15/22
6641,2,0,2,4,STAB12,1445,3/15/22
6642,0,1,3,4,CRAZE79,1448,3/15/22
6643,2,0,4,6,DRAGN36,1451,3/15/22
6644,1,0,3,4,CRAZE69,1457,3/15/22
6645,1,0,2,3,SCORE77,1503,3/15/22
6646,1,0,1,2,BALL75,1545,3/15/22
6647,1,3,2,6,DAWG05,14270,3/15/22
6648,1,0,1,2,DRAGN33,1500,3/15/22
6649,2,1,1,4,SMALL13,1521,3/15/22
6650,1,1,7,9,DRAGN72,1518,3/15/22
6651,2,1,1,4,SMALL14,1524,3/15/22
6652,3,0,2,5,SMALL16,1530,3/15/22
6653,1,0,1,2,PHNTM45,1527,3/15/22
6654,1,0,3,4,CRAZE66,1536,3/15/22
6656,1,0,7,8,DRAGN66,800,3/16/22
6657,2,0,2,4,PHNTM45,803,3/16/22
6658,4,1,5,10,BALL36,809,3/16/22
6659,1,1,1,3,WIRE31,815,3/16/22
6660,1,1,2,4,WIRE32,818,3/16/22
6661,4,1,2,7,PAWS43,830,3/16/22
6662,3,0,3,6,SMALL63,821,3/16/22
6663,2,2,2,6,BALL62,824,3/16/22
6664,1,0,1,2,COACH21,839,3/16/22
6665,1,0,1,2,COACH22,842,3/16/22
6666,2,0,3,5,DRAGN77,848,3/16/22
6667,2,0,7,9,COBRA01,836,3/16/22
6668,1,0,3,4,AXEL11,900,3/16/22
6669,1,0,2,3,AXEL12,903,3/16/22
6670,2,1,0,3,SPOT91,851,3/16/22
6671,2,1,1,4,SPOT92,854,3/16/22
6672,2,0,0,2,AMMO02,906,3/16/22
6673,2,1,1,4,HANG51,933,3/16/22
6674,2,1,4,7,HANG52,936,3/16/22
6675,1,2,1,4,CREEP31,939,3/16/22
6676,1,2,2,5,CREEP32,942,3/16/22
6677,2,1,0,3,SMALL23,945,3/16/22
6678,2,0,6,8,DRAGN32,948,3/16/22
6679,1,0,3,4,SHINR81,951,3/16/22
6680,1,0,1,2,SHINR82,954,3/16/22
6681,1,1,2,4,DRAGN99,1005,3/16/22
6682,1,0,3,4,DRAGN28,1000,3/16/22
6683,1,0,5,6,GIZMO21,1003,3/16/22
6684,1,0,0,1,GIZMO22,1006,3/16/22
6685,1,2,1,4,ETCH41,1021,3/16/22
6686,3,2,1,6,ETCH42,1024,3/16/22
6687,2,2,2,6,TORA31,1018,3/16/22
6688,2,2,3,7,TORA32,1021,3/16/22
6689,2,2,1,5,OUZO11,1012,3/16/22
6690,5,2,1,8,OUZO12,1015,3/16/22
6691,0,2,2,4,BALL56,1030,3/16/22
6692,1,2,3,6,BALL89,1033,3/16/22
6693,2,1,0,3,STAB11,1106,3/16/22
6694,2,1,3,6,STAB12,1109,3/16/22
6695,2,1,0,3,SMALL61,1115,3/16/22
6696,1,2,1,4,HOOK17,1118,3/16/22
6697,2,2,0,4,GIZMO11,1130,3/16/22
6698,1,2,0,3,GIZMO12,1133,3/16/22
6699,2,0,3,5,HANG51,1124,3/16/22
6700,3,0,2,5,HANG52,1127,3/16/22
6701,1,2,0,3,DRAGN03,1145,3/16/22
6702,1,2,4,7,TORA11,1136,3/16/22
6703,1,2,3,6,TORA12,1139,3/16/22
6704,1,3,3,7,DRAGN75,1142,3/16/22
6705,2,0,0,2,DRAGN61,1145,3/16/22
6706,1,1,4,6,DRAGN71,1148,3/16/22
6707,3,1,4,8,PHNTM45,1154,3/16/22
6708,1,2,5,8,DRAGN66,1157,3/16/22
6709,1,2,0,3,POST61,1200,3/16/22
6710,3,0,2,5,POST62,1203,3/16/22
6711,2,2,1,5,SMALL10,1212,3/16/22
6712,0,3,3,6,PAWS43,1209,3/16/22
6713,1,2,3,6,WIRE31,1215,3/16/22
6714,1,2,4,7,WIRE32,1218,3/16/22
6715,0,2,5,7,GHOST69,1221,3/16/22
6716,0,0,3,3,TORA21,1230,3/16/22
6717,3,1,4,8,SCARE09,1233,3/16/22
6718,1,1,4,6,BALL62,1224,3/16/22
6719,0,1,3,4,CRAZE14,1230,3/16/22
6720,0,1,2,3,BALL23,1239,3/16/22
6721,1,2,4,7,BALL39,1236,3/16/22
6722,3,2,1,6,BALL61,1242,3/16/22
6723,1,1,2,4,COACH21,1245,3/16/22
6724,1,1,3,5,COACH22,1248,3/16/22
6725,1,1,3,5,SCARE79,1227,3/16/22
6726,0,1,5,6,SCARE08,1300,3/16/22
6727,2,2,0,4,BALL81,1254,3/16/22
6728,2,2,1,5,BALL82,1257,3/16/22
6729,2,1,1,4,DRAGN91,1303,3/16/22
6730,1,1,1,3,EASY31,1251,3/16/22
6731,0,1,1,2,PHNTM55,1236,3/16/22
6732,2,2,6,10,DRAGN32,1400,3/16/22
6733,0,1,5,6,DRAGN34,1403,3/16/22
6734,1,1,2,4,SHINR81,1406,3/16/22
6735,1,1,3,5,SHINR82,1409,3/16/22
6736,0,2,3,5,DRAGN47,1415,3/16/22
6737,1,1,3,5,AXLE11,1442,3/16/22
6738,1,1,1,3,AXLE12,1445,3/16/22
6739,1,1,4,6,AMMO02,0,3/16/22
6740,1,1,2,4,HANG51,1451,3/16/22
6741,1,1,4,6,HANG52,1452,3/16/22
6742,1,1,1,3,STAB11,1503,3/16/22
6743,3,1,0,4,STAB,1503,3/16/22
6744,2,1,4,7,DRAGN37,1515,3/16/22
6745,2,1,2,5,DRAGN99,1524,3/16/22
6746,2,2,1,5,DRAGN61,1536,3/16/22
6747,1,3,3,7,DRAGN03,1530,3/16/22
6748,2,1,1,4,SMALL06,1506,3/16/22
6749,1,1,4,6,DRAGN75,1527,3/16/22
6750,1,1,3,5,CREEP31,1539,3/16/22
6751,1,1,3,5,DRAGN71,1533,3/16/22
6752,1,2,4,7,WIRE31,1621,3/16/22
6753,1,2,1,4,WIRE32,1624,3/16/22
6754,0,1,3,4,EPIC06,0,3/16/22
6755,1,2,5,8,STAB11,739,3/17/22
6756,1,2,4,7,VEGA21,733,3/17/22
6757,1,2,9,12,STAB12,729,3/17/22
6758,0,2,3,5,BALL62,754,3/17/22
6759,3,2,2,7,VEGA22,733,3/17/22
6760,1,2,3,6,WIRE31,745,3/17/22
6761,1,2,3,6,WIRE32,745,3/17/22
6762,0,2,3,5,LOOT50,751,3/17/22
6763,1,2,3,6,HANG51,803,3/17/22
6764,2,2,2,6,HANG52,803,3/17/22
6765,1,2,2,5,SPECK53,806,3/17/22
6766,2,0,2,4,PAWS43,812,3/17/22
6767,2,2,4,8,SHINR81,757,3/17/22
6768,2,2,4,8,SHINR82,757,3/17/22
6769,4,1,4,9,COACH21,815,3/17/22
6770,1,1,4,6,COACH22,815,3/17/22
6771,2,1,3,6,RHINO99,730,3/17/22
6772,0,2,4,6,SCARE08,809,3/17/22
6773,1,2,3,6,RECON81,830,3/17/22
6774,2,1,3,6,RECON77,824,3/17/22
6775,1,1,6,8,DRAGN91,836,3/17/22
6776,0,2,4,6,BALL56,957,3/17/22
6777,3,2,5,10,BADGR08,821,3/17/22
6778,4,1,0,5,DRAGN99,833,3/17/22
6779,1,2,3,6,SCARE59,848,3/17/22
6780,1,2,3,6,AXLE11,842,3/17/22
6781,1,2,1,4,AXLE12,842,3/17/22
6782,3,1,1,5,RECON71,839,3/17/22
6783,1,1,7,9,CREEP32,851,3/17/22
6784,0,1,3,4,HOOK47,900,3/17/22
6785,1,2,1,4,DRAGN05,857,3/17/22
6786,1,1,0,2,CREEP31,851,3/17/22
6787,2,1,2,5,DRAGN34,903,3/17/22
6788,2,1,4,7,DRAGN37,906,3/17/22
6789,1,2,0,3,DRAGN28,912,3/17/22
6790,2,2,3,7,DRAGN75,921,3/17/22
6791,2,1,1,4,DRAGN77,924,3/17/22
6792,2,2,2,6,SMALL15,927,3/17/22
6793,2,1,2,5,GIZMO21,933,3/17/22
6794,1,1,0,2,GIZMO22,933,3/17/22
6795,1,2,3,6,DRAGN24,915,3/17/22
6796,1,4,2,7,DRAGN21,918,3/17/22
6797,2,4,2,8,LOST11,939,3/17/22
6798,1,4,1,6,LOST12,939,3/17/22
6799,2,4,2,8,TORA21,945,3/17/22
6800,2,4,2,8,TORA22,945,3/17/22
6801,2,2,2,6,TAUNT21,1000,3/17/22
6802,1,2,1,4,TAUNT22,1000,3/17/22
6803,2,4,1,7,GIZMO41,951,3/17/22
6804,2,4,1,7,GIZMO42,951,3/17/22
6805,0,5,4,9,HOOK03,1054,3/17/22
6806,2,1,1,4,TORA11,1039,3/17/22
6807,1,1,0,2,TORA12,1039,3/17/22
6808,2,0,0,2,STAB11,1045,3/17/22
6809,2,0,1,3,STAB12,1045,3/17/22
6810,0,2,3,5,HOOK71,1051,3/17/22
6811,2,2,5,9,TORA51,1057,3/17/22
6812,1,2,4,7,TORA52,1057,3/17/22
6813,1,3,1,5,DRAGN69,1118,3/17/22
6814,0,1,4,5,HOOK66,1112,3/17/22
6815,0,3,0,3,DRAGN61,1109,3/17/22
6816,1,4,1,6,PHANTM45,1115,3/17/22
6817,2,1,1,4,SMALL55,1103,3/17/22
6818,3,2,1,6,SMALL63,1121,3/17/22
6819,1,1,1,3,EASY31,1131,3/17/22
6820,4,2,6,12,BADGR09,1130,3/17/22
6821,1,2,1,4,WIRE31,1139,3/17/22
6822,1,2,2,5,WIRE32,1139,3/17/22
6823,1,2,6,9,SHINR81,1145,3/17/22
6824,1,2,7,10,SHINR82,1145,3/17/22
6825,1,3,6,10,HANG51,1133,3/17/22
6826,1,3,4,8,HANG52,1136,3/17/22
6827,1,2,5,8,FURY02,1151,3/17/22
6828,1,4,3,8,POST61,1124,3/17/22
6829,3,4,1,8,POST62,1127,3/17/22
6830,0,2,3,5,CRAZE14,1154,3/17/22
6831,1,1,2,4,PAWS43,1200,3/17/22
6832,1,1,4,6,VEGA21,1209,3/17/22
6833,3,1,0,4,VEGA22,1209,3/17/22
6834,1,2,3,6,BALL51,1157,3/17/22
6835,1,1,5,7,AXEL11,1215,3/17/22
6836,1,1,1,3,AXEL12,1215,3/17/22
6837,1,1,2,4,COACH21,1203,3/17/22
6838,3,1,3,7,COACH22,1206,3/17/22
6839,0,2,4,6,RECON89,1224,3/17/22
6840,1,4,4,9,SPOT91,1227,3/17/22
6841,3,4,5,12,SPOT92,1227,3/17/22
6842,0,1,3,4,BUBO11,1215,3/17/22
6843,1,4,1,6,CREEP31,1333,3/17/22
6844,3,4,0,7,CREEP32,1336,3/17/22
6845,1,6,1,8,RENO71,1406,3/17/22
6846,1,6,4,11,RENO72,1406,3/17/22
6847,1,3,3,7,DRAGN33,1415,3/17/22
6848,1,5,1,7,DRAGN21,1421,3/17/22
6849,1,5,5,11,DRAGN24,1424,3/17/22
6850,1,5,2,8,DRAGN99,1418,3/17/22
6851,2,6,2,10,SMALL66,1430,3/17/22
6852,1,4,2,7,DRAGN75,1427,3/17/22
6853,1,2,0,3,DRAGN72,1433,3/17/22
6854,1,2,2,5,DRAGN61,1445,3/17/22
6855,0,5,4,9,DRAGN66,1448,3/17/22
6856,2,6,3,11,SMALL75,1451,3/17/22
6857,2,6,1,9,SMALL76,1454,3/17/22
6858,1,3,0,4,STAB11,1121,3/18/22
6859,2,3,1,6,TORA21,1115,3/18/22
6860,1,3,2,6,DRAGN75,1133,3/18/22
6861,1,5,4,10,PHANTM45,1145,3/18/22
6862,0,4,1,5,BALL42,1136,3/18/22
6863,1,4,1,6,RENO71,1221,3/18/22
6864,0,5,5,10,EPIC02,1242,3/18/22
6865,0,4,0,4,AMMO04,1209,3/18/22
6866,1,4,2,7,LOOT50,1230,3/18/22
6867,2,4,2,8,SMALL25,1251,3/18/22
6868,1,6,0,7,RENO71,1303,3/18/22
6869,0,6,4,10,BALL34,1300,3/18/22
6870,0,5,2,7,RECON08,1300,3/18/22
6871,1,3,5,9,BALL56,1239,3/18/22
6872,1,4,8,13,TORA51,1126,3/18/22
6873,1,6,8,15,AXLE11,1340,3/18/22
6874,2,5,3,10,GOLEM11,1415,3/18/22
6875,2,3,4,9,SHINR81,1409,3/18/22
6876,0,5,0,5,HOOK81,1410,3/18/22
6877,3,4,2,9,SMALL67,1433,3/18/22
6878,1,4,5,10,VEGA21,1436,3/18/22
6879,1,3,2,6,BALL19,1445,3/18/22
6880,0,4,4,8,DRAGN91,1454,3/18/22
6881,0,3,0,3,BALL42,1515,3/18/22
6882,5,3,3,11,HOOK66,1500,3/18/22
6883,0,3,2,5,CRAZE22,1509,3/18/22
6884,1,4,0,5,DRAGN33,1506,3/18/22
6885,1,2,1,4,PAWS61,1524,3/18/22
6886,2,2,1,5,DRAGN28,1503,3/18/22
6887,1,4,0,5,EASY18,1510,3/18/22
6888,0,5,3,8,HOOK17,1318,3/18/22
6889,1,3,1,5,LOST11,1527,3/18/22
6890,1,3,0,4,LOST12,1530,3/18/22
6891,1,3,3,7,HOOK75,1451,3/18/22
6892,2,8,0,10,TORA61,1442,3/18/22
6893,1,8,0,9,TORA62,1445,3/18/22
6894,2,1,0,3,GIZMO31,1533,3/18/22
6895,1,4,2,7,GIZMO32,1536,3/18/22
6896,2,2,0,4,LOST21,1527,3/18/22
6897,2,2,0,4,LOST22,1530,3/18/22
6898,0,3,1,4,HOOK72,1451,3/18/22
6899,2,7,3,12,PHNTM48,827,3/21/22
6900,0,7,1,8,FURY01,836,3/21/22
6901,4,5,5,14,CRAZE16,857,3/21/22
6902,1,1,0,2,AMMO01,857,3/21/22
6903,0,4,4,8,AMMO04,845,3/21/22
6904,2,3,2,7,BADGR04,906,3/21/22
6905,1,7,5,13,SPOT91,900,3/21/22
6906,1,5,3,9,SPECK53,839,3/21/22
6907,2,2,1,5,AXLE11,848,3/21/22
6908,2,1,2,5,AXLE12,848,3/21/22
6909,1,7,1,9,WIRE31,909,3/21/22
6910,1,7,0,8,WIRE32,912,3/21/22
6911,1,3,0,4,DRAGN69,948,3/21/22
6912,0,7,1,8,BALL45,927,3/21/22
6913,0,2,0,2,DRAGN05,936,3/21/22
6914,0,2,1,3,CRAZE86,918,3/21/22
6915,0,7,2,9,DRAGN28,957,3/21/22
6916,1,5,1,7,DRAGN22,1003,3/21/22
6917,1,9,5,15,DRAGN83,1000,3/21/22
6918,2,1,7,10,DRAGN37,1012,3/21/22
6919,1,5,1,7,DRAGN34,1015,3/21/22
6920,2,6,1,9,DRAGN36,1018,3/21/22
6921,1,9,0,10,TORA21,1136,3/22/22
6922,1,9,2,12,TORA21,1136,3/22/22
6923,1,8,2,11,DRAGN42,1215,3/22/22
6924,2,8,1,11,STAB11,1224,3/22/22
6925,1,8,3,12,STAB11,1227,3/22/22
6926,0,7,0,7,BALL88,1006,3/22/22
6927,0,8,3,11,BALL56,1415,3/22/22
6928,0,6,5,11,DRAGN 37,845,3/23/22
6929,2,0,2,4,DAWG04,809,3/23/22
6930,3,3,1,7,AXEL11,833,3/23/22
6931,3,3,1,7,AXEL12,836,3/23/22
6932,0,5,5,10,DRAGN31,842,3/23/22
6933,4,4,2,10,BADGR 04,900,3/23/22
6934,3,2,4,9,AMMO 08,848,3/23/22
6935,1,4,2,7,BALL 36,918,3/23/22
6936,1,5,3,9,BALL 28,854,3/23/22
6937,1,3,1,5,AMMO 01,851,3/23/22
6938,4,3,0,7,CRAZE 16,909,3/23/22
6939,0,6,4,10,BALL 29,857,3/23/22
6940,4,2,2,8,CRAZE 54,906,3/23/22
6941,0,5,2,7,BALL 25,903,3/23/22
6942,1,7,3,11,VEGA 21,912,3/23/22
6943,1,7,1,9,VEGA 22,915,3/23/22
6944,1,3,2,6,DRAGN 71,924,3/23/22
6945,1,4,1,6,DRAGN 03,927,3/23/22
6946,1,3,0,4,COACH 21,930,3/23/22
6947,1,3,0,4,COACH 22,933,3/23/22
6948,1,5,0,6,PAWS 61,939,3/23/22
6949,1,5,1,7,WIRE 31,942,3/23/22
6950,1,5,1,7,WIRE 32,945,3/23/22
6951,3,3,0,6,PAWS 76,954,3/23/22
6952,2,2,0,4,HOOK 21,912,3/23/22
6953,1,1,5,7,CRAZE 11,948,3/23/22
6954,1,2,0,3,AMMO 05,951,3/23/22
6955,0,6,4,10,AMMO 04,1006,3/23/22
6956,2,6,2,10,BALL 52,1003,3/23/22
6957,1,4,3,8,PAWS 14,957,3/23/22
6958,1,4,2,7,HANG 51,1009,3/23/22
6959,1,4,2,7,HANG 52,1012,3/23/22
6960,1,3,3,7,CRAZE 86,1015,3/23/22
6961,1,4,3,8,STAB 11,1018,3/23/22
6962,1,4,3,8,STAB 12,1021,3/23/22
6963,0,6,2,8,BALL 34,1045,3/23/22
6964,3,3,2,8,GIZMO 21,1024,3/23/22
6965,3,3,2,8,GIZMO 22,1027,3/23/22
6966,0,4,3,7,BALL 69,1033,3/23/22
6967,1,4,2,7,SLOW 61,1033,3/23/22
6968,1,4,2,7,SLOW 62,1036,3/23/22
6969,1,4,1,6,PAWS 43,1048,3/23/22
6970,0,4,4,8,PAWS 48,1042,3/23/22
6971,2,4,0,6,LOST 11,1054,3/23/22
6972,2,4,0,6,LOST 12,1057,3/23/22
6973,2,6,1,9,GIZMO 31,1100,3/23/22
6974,2,6,1,9,GIZMO 32,1103,3/23/22
6975,3,5,1,9,LOOT 48,1051,3/23/22
6976,0,4,5,9,HOOK 08,1145,3/23/22
6977,1,5,1,7,TORA 21,1130,3/23/22
6978,1,5,2,8,TORA 22,1133,3/23/22
6979,0,3,4,7,PHNTM 45,1136,3/23/22
6980,1,6,1,8,TORA51,1142,3/23/22
6981,3,6,0,9,TORA52,1142,3/23/22
6982,1,2,5,8,SLOW31,1200,3/23/22
6983,1,2,2,5,SLOW32,1203,3/23/22
6984,2,5,1,8,SLOW11,1154,3/23/22
6985,2,5,3,10,SLOW12,1157,3/23/22
6986,1,6,3,10,GOLEM41,1148,3/23/22
6987,1,6,4,11,GOLEM42,1151,3/23/22
6988,2,2,0,4,CREEP31,1206,3/23/22
6989,2,2,1,5,CREEP32,1209,3/23/22
6990,0,4,4,8,GHOST69,1212,3/23/22
6991,1,2,1,4,AMMO09,1224,3/23/22
6992,1,5,5,11,BALL41,1215,3/23/22
6993,1,3,4,8,BALL11,1227,3/23/22
6994,1,4,2,7,SHINR81,1233,3/23/22
6995,1,5,6,12,SHINR82,1233,3/23/22
6996,1,4,2,7,AXLE11,1218,3/23/22
6997,1,4,3,8,AXLE12,1221,3/23/22
6998,4,5,2,11,BADGR04,1248,3/23/22
6999,4,3,0,7,FURY04,1251,3/23/22
7000,2,2,2,6,CRAZE16,1254,3/23/22
7001,4,5,3,12,BADGR09,1245,3/23/22
7002,2,4,5,11,RECON04,1242,3/23/22
7003,0,2,4,6,BADGR05,1257,3/23/22
7004,2,4,0,6,PAWS01,1312,3/23/22
7005,2,4,0,6,PAWS02,1315,3/23/22
7006,1,3,3,7,RENO71,1300,3/23/22
7007,1,3,5,9,RENO72,1303,3/23/22
7008,2,4,1,7,GIZMO11,1106,3/23/22
7009,2,4,0,6,GIZMO12,1109,3/23/22
7010,3,2,3,8,AMMO02,1306,3/23/22
7011,2,5,2,9,BALL81,1318,3/23/22
7012,2,4,2,8,BALL89,1321,3/23/22
7013,1,2,2,5,BALL72,1400,3/23/22
7014,1,5,1,7,DRAGN33,1515,3/23/22
7015,1,4,2,7,DRAGN22,1512,3/23/22
7016,1,4,1,6,DRAGN28,1509,3/23/22
7017,1,4,4,9,SPECK48,1521,3/23/22
7018,1,4,2,7,DRAGN24,1518,3/23/22
7019,1,4,5,10,CRAZE11,1524,3/23/22
7020,0,5,3,8,RECON81,833,3/24/22
7021,1,6,1,8,SPOT91,839,3/24/22
7022,1,6,1,8,SPOT92,842,3/24/22
7023,1,4,2,7,CRAZE61,833,3/24/22
7024,0,3,4,7,EPIC02,848,3/24/22
7025,3,1,1,5,PHNTM03,845,3/24/22
7026,1,3,0,4,CRAZE76,900,3/24/22
7027,1,3,3,7,AMMO08,903,3/24/22
7028,1,2,1,4,AMMO09,909,3/24/22
7029,1,1,3,5,BALL51,854,3/24/22
7030,1,1,2,4,AMMO05,906,3/24/22
7031,2,2,0,4,RHINO99,900,3/24/22
7032,1,3,2,6,LOOT06,912,3/24/22
7033,1,2,3,6,AMMO02,915,3/24/22
7034,0,3,0,3,HOOK33,857,3/24/22
7035,0,4,1,5,PAWS16,918,3/24/22
7036,2,3,2,7,BADGR04,857,3/24/22
7037,0,3,3,6,BALL29,924,3/24/22
7038,2,4,1,7,RECON08,921,3/24/22
7039,0,6,3,9,BALL39,936,3/24/22
7040,1,2,0,3,CRAZE54,939,3/24/22
7041,0,6,0,6,RECON89,942,3/24/22
7042,1,4,3,8,WIRE31,951,3/24/22
7043,1,4,6,11,WIRE32,954,3/24/22
7044,1,4,3,8,RENO71,930,3/24/22
7045,1,4,2,7,RENO72,930,3/24/22
7046,2,4,3,9,DRAGN83,945,3/24/22
7047,1,2,2,5,DRAGN05,948,3/24/22
7048,1,3,1,5,DRAGN21,1003,3/24/22
7049,1,1,1,3,DRAGN24,1006,3/24/22
7050,0,3,3,6,DRAGN99,1000,3/24/22
7051,2,2,1,5,DRAGN22,1009,3/24/22
7052,1,1,2,4,DRAGN28,1012,3/24/22
7053,2,2,4,8,DRAGN37,1024,3/24/22
7054,2,4,3,9,SPECK48,957,3/24/22
7055,2,2,4,8,DRAGN34,1018,3/24/22
7056,0,5,1,6,SPECK53,1030,3/24/22
7057,0,0,0,0,A,0,3/24/22
7058,1,4,1,6,DRAGN03,1036,3/24/22
7059,4,5,0,9,CRAZE44,1039,3/24/22
7060,2,3,1,6,PAWS43,1048,3/24/22
7061,2,4,1,7,STAB11,1042,3/24/22
7062,2,4,1,7,STAB12,1042,3/24/22
7063,2,4,1,7,LOOT48,1051,3/24/22
7064,1,4,1,6,DRAGN71,1033,3/24/22
7065,2,3,1,6,BALL36,1057,3/24/22
7066,2,3,1,6,LOOT50,1100,3/24/22
7067,0,4,2,6,PAWS34,1054,3/24/22
7068,1,1,0,2,BALL87,1103,3/24/22
7069,1,3,4,8,TORA31,1133,3/24/22
7070,1,3,0,4,TORA32,1136,3/24/22
7071,1,3,2,6,TORA11,1139,3/24/22
7072,1,3,2,6,DRAGN75,1151,3/24/22
7073,0,3,1,4,DRAGN69,1200,3/24/22
7074,2,2,2,6,CRAZE47,1154,3/24/22
7075,2,1,0,3,SHINR81,1145,3/24/22
7076,0,2,2,4,CRAZE86,1203,3/24/22
7077,1,2,3,6,SCARE75,1206,3/24/22
7078,1,3,1,5,BALL69,1715,3/24/22
7079,1,2,3,6,ETCH41,1209,3/24/22
7080,1,1,2,4,ETCH41,1212,3/24/22
7081,1,1,1,3,CREEP31,1218,3/24/22
7082,1,1,1,3,CREEP31,1221,3/24/22
7083,2,2,4,8,SPOT91,1230,3/24/22
7084,1,2,2,5,SPOT92,1233,3/24/22
7085,3,2,3,8,BALL11,1239,3/24/22
7086,1,5,3,9,AXLE11,1230,3/24/22
7087,1,5,1,7,AXLW12,1233,3/24/22
7088,2,2,6,10,AMMO08,1236,3/24/22
7089,1,2,5,8,AMMO02,1248,3/24/22
7090,1,1,1,3,AMMO09,1251,3/24/22
7091,2,1,8,11,RECON03,1254,3/24/22
7092,1,1,7,9,BALL56,1303,3/24/22
7093,2,1,3,6,BADGR04,1315,3/24/22
7094,0,0,4,4,BALL52,1257,3/24/22
7095,0,2,4,6,LOOT06,1245,3/24/22
7096,0,3,2,5,PAWS14,1300,3/24/22
7097,1,0,3,4,COACH21,1306,3/24/22
7098,1,0,2,3,COACH22,1312,3/24/22
7099,1,2,4,7,AMMO05,1242,3/24/22
7100,0,2,5,7,BALL29,1309,3/24/22
7101,4,3,2,9,RECON04,1321,3/24/22
7102,2,2,0,4,BADGR05,1318,3/24/22
7103,1,3,3,7,RENO71,1324,3/24/22
7104,1,3,2,6,RENO72,1327,3/24/22
7105,1,0,0,1,DRAGN96,1329,3/24/22
7106,2,3,1,6,BALL31,1330,3/24/22
7107,3,3,4,10,BALL91,1342,3/24/22
7108,2,3,2,7,BALL92,1345,3/24/22
7109,1,3,3,7,SPECK53,1509,3/24/22
7110,2,2,3,7,SCARE99,1515,3/24/22
7111,1,2,2,5,DRAGN46,1500,3/24/22
7112,0,2,2,4,RABID61,0,3/24/22
7113,1,4,2,7,DRAGN22,1521,3/24/22
7114,1,2,3,6,CRAZE47,1557,3/24/22
7115,1,2,2,5,DRAGN83,1548,3/24/22
7116,1,3,2,6,DRAGN75,1551,3/24/22
7117,3,3,3,9,DRAGN71,1554,3/24/22
7118,2,3,3,8,DRAGN36,1545,3/24/22
7119,1,2,2,5,CRAZE86,1600,3/24/22
7120,0,2,0,2,LOOT51,1603,3/24/22
7121,1,2,0,3,WIRE31,1609,3/24/22
7122,2,2,2,6,WIRE32,1612,3/24/22
7123,1,2,1,4,STAB11,1621,3/24/22
7124,3,2,1,6,STAB12,1624,3/24/22
7125,1,1,5,7,ETCH41,1627,3/24/22
7126,1,1,1,3,ETCH42,1630,3/24/22
7127,2,1,2,5,HANG51,1615,3/24/22
7128,2,1,2,5,HANG52,1618,3/24/22
7129,1,1,4,6,LOOT06,836,3/25/22
7130,1,5,3,9,SCARE77,830,3/25/22
7131,1,4,1,6,CRAZE61,833,3/25/22
7132,1,0,3,4,EASY85,831,3/25/22
7133,1,3,2,6,CRAZE76,839,3/25/22
7134,1,2,3,6,AMMO01,842,3/25/22
7135,3,3,1,7,BALL19,845,3/25/22
7136,2,4,3,9,AMMO08,848,3/25/22
7137,2,2,1,5,BADGR04,900,3/25/22
7138,3,3,1,7,LOST11,851,3/25/22
7139,1,3,2,6,LOST12,857,3/25/22
7140,2,2,1,5,BADGR09,839,3/25/22
7141,2,3,1,6,SMALL11,915,3/25/22
7142,2,5,2,9,SMALL05,903,3/25/22
7143,0,2,1,3,DRAGN65,918,3/25/22
7144,1,6,0,7,ETCH41,936,3/25/22
7145,1,6,5,12,ETCH42,939,3/25/22
7146,2,5,1,8,TORA51,921,3/25/22
7147,2,5,2,9,TORA52,924,3/25/22
7148,1,4,1,6,STAB11,930,3/25/22
7149,1,4,0,5,STAB12,933,3/25/22
7150,0,2,3,5,PHNTM,927,3/25/22
7151,1,2,3,6,DRAGN46,942,3/25/22
7152,1,2,1,4,DRAGN28,951,3/25/22
7153,3,1,2,6,SMALL24,948,3/25/22
7154,2,1,1,4,DRAGN22,945,3/25/22
7155,2,1,3,6,DRAGN31,1003,3/25/22
7156,1,1,1,3,DRAGN83,954,3/25/22
7157,0,2,1,3,DRAGN69,1027,3/25/22
7158,1,2,2,5,BALL99,1009,3/25/22
7159,2,3,2,7,SMALL32,1151,3/25/22
7160,2,2,1,5,CRAZE47,1015,3/25/22
7161,1,4,1,6,DRAGN75,1012,3/25/22
7162,1,4,2,7,DRAGN03,1018,3/25/22
7163,3,2,0,5,SMALL37,1021,3/25/22
7164,2,1,1,4,BALL02,1024,3/25/22
7165,1,4,2,7,HANG51,1033,3/25/22
7166,3,4,0,7,HANG52,1036,3/25/22
7167,3,0,2,5,CRAZE77,1030,3/25/22
7168,1,4,2,7,SCARE72,1042,3/25/22
7169,0,3,1,4,PAWS43,1039,3/25/22
7170,2,4,1,7,BALL36,1057,3/25/22
7171,2,3,0,5,PAWS43,1100,3/25/22
7172,1,2,3,6,TORA21,1145,3/25/22
7173,1,2,4,7,TORA22,1148,3/25/22
7174,1,2,3,6,TORA21,1145,3/25/22
7175,1,2,4,7,TORA22,1145,3/25/22
7176,0,1,1,2,MANLY11,1045,3/25/22
7177,0,1,2,3,MANLY12,1048,3/25/22
7178,2,1,1,4,SLOW31,1157,3/25/22
7179,1,2,1,4,SHINR81,1151,3/25/22
7180,1,2,3,6,SHINR82,1151,3/25/22
7181,1,2,1,4,AMMO01,1403,3/25/22
7182,2,3,4,9,BALL61,1351,3/25/22
7183,1,3,2,6,BALL19,1221,3/25/22
7184,3,2,3,8,AMMO02,1209,3/25/22
7185,2,2,5,9,CRAZE76,1215,3/25/22
7186,5,2,1,8,BALL15,1212,3/25/22
7187,1,3,3,7,AXLE11,1224,3/25/22
7188,1,3,1,5,AXLE12,1224,3/25/22
7189,1,5,2,8,GOLEM41,1051,3/25/22
7190,1,5,1,7,GOLEM42,1051,3/25/22
7191,0,3,0,3,LOOT48,1242,3/25/22
7192,1,5,3,9,POST61,1245,3/25/22
7193,1,5,0,6,POST61,1245,3/25/22
7194,4,3,3,10,BADGR04,1300,3/25/22
7195,1,2,4,7,CREEP31,1251,3/25/22
7196,1,2,2,5,CREEP32,1251,3/25/22
7197,1,2,2,5,EASY86,1255,3/25/22
7198,2,1,2,5,BADGR08,1257,3/25/22
7199,1,2,4,7,RENO71,1303,3/25/22
7200,1,2,2,5,RENO72,1303,3/25/22
7201,1,2,3,6,DRAGN99,1321,3/25/22
7202,1,3,4,8,DRAGN46,1333,3/25/22
7203,2,2,1,5,DRAGN22,1324,3/25/22
7204,2,4,1,7,GOLEM11,11,3/25/22
7205,2,4,2,8,GOLEM12,1348,3/25/22
7206,1,5,1,7,LOST11,1342,3/25/22
7207,1,5,7,13,LOST12,1342,3/25/22
7208,0,2,0,2,CRAZE44,1203,3/25/22
7209,1,2,1,4,HOOK83,1336,3/25/22
7210,1,4,0,5,RECON81,1357,3/25/22
7211,0,3,1,4,BALL88,1354,3/25/22
7212,2,3,1,6,LOST51,1615,3/25/22
7213,2,3,0,5,LOST52,1309,3/25/22
7214,0,3,0,3,COBRA01,1524,3/25/22
7215,2,3,2,7,DRAGN75,1536,3/25/22
7216,1,3,3,7,CRAZE86,1539,3/25/22
7217,1,2,1,4,HOOK83,1345,3/25/22
7218,0,2,0,2,AMMO04,1524,3/25/22
7219,1,5,0,6,FILL31,1315,3/25/22
7220,1,5,0,6,FILL32,1318,3/25/22
7221,2,4,1,7,BALL03,1548,3/25/22
7222,0,2,0,2,BALL52,1600,3/25/22
7223,2,2,1,5,SPECK53,1603,3/25/22
7224,2,2,0,4,BALL08,1606,3/25/22
7225,1,3,1,5,BALL62,1545,3/25/22
7226,1,3,2,6,VEGA21,1636,3/25/22
7227,1,3,5,9,VEGA22,1639,3/25/22
7228,1,1,1,3,BALL72,1551,3/25/22
7229,2,1,2,5,BALL51,1557,3/25/22
7230,1,3,2,6,LOST81,1618,3/25/22
7231,1,3,1,5,LOST82,1621,3/25/22
7232,0,1,1,2,TORA11,1630,3/25/22
7233,0,1,3,4,TORA12,1615,3/25/22
7234,2,5,1,8,GIZMO21,1709,3/25/22
7235,2,5,0,7,GIZMO22,1712,3/25/22
7236,0,3,0,3,HOOK21,1609,3/25/22
7237,2,0,3,5,BALL44,1645,3/25/22
7238,4,3,2,9,CRAZE54,836,3/28/22
7239,0,1,2,3,BADGER01,839,3/28/22
7240,1,2,0,3,BALL19,848,3/28/22
7241,2,2,5,9,SPOT91,842,3/28/22
7242,2,2,2,6,SPOT92,845,3/28/22
7243,4,2,2,8,BALL12,857,3/28/22
7244,1,1,0,2,AMMO01,854,3/28/22
7245,1,2,1,4,CRAZE76,851,3/28/22
7246,2,3,1,6,RHINO99,830,3/28/22
7247,2,2,2,6,SMALL11,915,3/28/22
7248,2,1,4,7,CRAZE13,912,3/28/22
7249,4,0,0,4,SMALL04,900,3/28/22
7250,1,1,3,5,DRAGN03,927,3/28/22
7251,2,1,2,5,POST61,918,3/28/22
7252,1,1,0,2,POST62,921,3/28/22
7253,0,1,0,1,DRAGN75,933,3/28/22
7254,2,2,0,4,SMALL07,909,3/28/22
7255,2,2,1,5,SMALL10,912,3/28/22
7256,2,2,1,5,SMALL06,906,3/28/22
7257,0,2,2,4,BALL69,924,3/28/22
7258,3,2,0,5,CRAZE47,930,3/28/22
7259,3,0,0,3,SMALL26,954,3/28/22
7260,0,1,2,3,DRAGN62,951,3/28/22
7261,1,1,0,2,BALL79,939,3/28/22
7262,1,2,2,5,DRAGN91,945,3/28/22
7263,0,1,0,1,DRAGN99,957,3/28/22
7264,1,0,1,2,CRAZE33,942,3/28/22
7265,2,1,1,4,SMALL34,1021,3/28/22
7266,2,1,0,3,SMALL35,1015,3/28/22
7267,3,0,0,3,SMALL41,1027,3/28/22
7268,3,0,0,3,SMALL43,1033,3/28/22
7269,3,1,3,7,PAWS46,1000,3/28/22
7270,1,1,5,7,DRAGN21,1024,3/28/22
7271,1,1,6,8,STAB11,1018,3/28/22
7272,2,1,0,3,STAB12,1021,3/28/22
7273,2,2,3,7,CREEP31,1006,3/28/22
7274,2,2,3,7,CREEP32,1009,3/28/22
7275,1,1,3,5,DRAGN83,1030,3/28/22
7276,1,0,1,2,SHINR81,1039,3/28/22
7277,3,0,1,4,SHINR82,1042,3/28/22
7278,0,1,0,1,BALL62,833,3/28/22
7279,1,2,5,8,GOLEM41,1051,3/28/22
7280,1,2,3,6,GOLEM42,1054,3/28/22
7281,1,0,1,2,DRAGN28,1036,3/28/22
7282,2,0,2,4,SMALL47,1045,3/28/22
7283,1,1,4,6,DRAGN32,1048,3/28/22
7284,1,3,4,8,LOOT50,1057,3/28/22
7285,3,1,4,8,AXLE11,1145,3/28/22
7286,1,1,1,3,AXLE12,1148,3/28/22
7287,3,2,0,5,PHNTM55,1103,3/28/22
7288,1,2,0,3,GIZMO11,1151,3/28/22
7289,3,1,0,4,GIZMO12,1154,3/28/22
7290,3,1,0,4,SMALL04,1200,3/28/22
7291,2,1,0,3,SMALL77,1157,3/28/22
7292,1,1,2,4,WIRE31,1203,3/28/22
7293,1,1,3,5,WIRE32,1206,3/28/22
7294,1,1,2,4,TORA21,1215,3/28/22
7295,1,1,3,5,TORA22,1218,3/28/22
7296,2,2,0,4,GIZMO21,1209,3/28/22
7297,2,2,0,4,GIZMO22,1212,3/28/22
7298,3,1,6,10,AMMO08,1239,3/28/22
7299,0,0,4,4,AMMO09,1233,3/28/22
7300,3,0,3,6,AMMO02,1242,3/28/22
7301,2,0,2,4,RECON82,1230,3/28/22
7302,1,1,0,2,AMMO05,1245,3/28/22
7303,3,1,2,6,SMALL20,1236,3/28/22
7304,2,1,1,4,SMALL77,1257,3/28/22
7305,0,1,3,4,PAWS13,1248,3/28/22
7306,1,2,2,5,GHOST02,1300,3/28/22
7307,1,3,5,9,TAUNT21,1251,3/28/22
7308,1,3,6,10,TAUNT22,1254,3/28/22
7309,2,1,0,3,SMALL33,1309,3/28/22
7310,1,1,2,4,HOOK11,1306,3/28/22
7311,1,1,2,4,RENO71,1303,3/28/22
7312,1,1,1,3,RENO72,1306,3/28/22
7313,3,1,0,4,OUZ071,1312,3/28/22
7314,3,1,1,5,OUZO72,1315,3/28/22
7315,1,2,3,6,SPECK53,1324,3/28/22
7316,1,2,2,5,SCARE72,1327,3/28/22
7317,3,1,1,5,SMALL47,1345,3/28/22
7318,1,2,2,5,RECON03,1336,3/28/22
7319,3,2,4,9,RECON02,1336,3/28/22
7320,1,1,2,4,DRAGN77,1342,3/28/22
7321,1,2,4,7,DRAGN75,1348,3/28/22
7322,0,2,1,3,DRAGN69,1321,3/28/22
7323,3,1,4,8,RECON89,1436,3/28/22
7324,1,2,2,5,OUZO31,1439,3/28/22
7325,1,2,1,4,OUZA32,1442,3/28/22
7326,0,1,1,2,PHNTM45,1521,3/28/22
7327,0,0,2,2,DRAGN68,1524,3/28/22
7328,1,0,1,2,SMALL15,1527,3/28/22
7329,1,2,2,5,STAB11,1530,3/28/22
7330,3,2,3,8,STAB12,1533,3/28/22
7331,1,1,1,3,CREEP31,1536,3/28/22
7332,3,1,1,5,CREEP32,1539,3/28/22
7333,3,1,1,5,DRAGN99,1542,3/28/22
7334,3,0,1,4,SMALL22,1554,3/28/22
7335,2,0,0,2,SMALL24,1548,3/28/22
7336,2,1,3,6,HOOK52,1533,3/28/22
7337,1,1,4,6,DRAGN83,1551,3/28/22
7338,1,2,7,10,HOOK37,1612,3/28/22
7339,2,0,4,6,DRAGN32,1615,3/28/22
7340,3,1,4,8,DRAGN39,1618,3/28/22
7341,1,2,4,7,DRAGN31,1609,3/28/22
7342,1,1,4,6,DRAGN46,1703,3/28/22
7343,1,4,1,6,FILL31,1745,3/28/22
7344,1,4,3,8,FILL32,1748,3/28/22
7345,2,1,5,8,BALL82,2000,3/28/22
7346,2,3,2,7,PAWS34,1957,3/28/22
7347,1,1,2,4,PHNTM45,103,3/28/22
7348,1,1,0,2,RECON88,2454,3/28/22
7349,1,1,4,6,EPIC06,2030,3/28/22
7350,0,0,0,0,RENO71,0,3/29/22
7351,1,6,3,10,RENO71,830,3/29/22
7352,1,6,3,10,RENO72,833,3/29/22
7353,1,4,3,8,PHNTM77,836,3/29/22
7354,1,6,2,9,BADGR04,839,3/29/22
7355,0,1,0,1,BALL19,848,3/29/22
7356,1,1,3,5,BUBO31,845,3/29/22
7357,1,6,5,12,SCARE71,842,3/29/22
7358,2,4,7,13,MANLY11,857,3/29/22
7359,3,4,1,8,MANLY12,900,3/29/22
7360,1,6,5,12,AMMO04,909,3/29/22
7361,1,5,2,8,DRAGN91,927,3/29/22
7362,0,4,1,5,DRAGN69,951,3/29/22
7363,3,5,2,10,GOLEM41,903,3/29/22
7364,3,5,5,13,GOLEM42,906,3/29/22
7365,2,3,2,7,SHINR81,930,3/29/22
7366,1,3,2,6,SHINR82,933,3/29/22
7367,0,6,4,10,DRAGN72,939,3/29/22
7368,2,7,2,11,LOOT06,924,3/29/22
7369,2,6,4,12,HANG51,945,3/29/22
7370,2,6,4,12,HANG52,948,3/29/22
7371,2,6,1,9,SMALL26,954,3/29/22
7372,2,6,0,8,SMALL27,957,3/29/22
7373,1,6,3,10,CRAZE77,1000,3/29/22
7374,2,6,0,8,SMALL31,1003,3/29/22
7375,1,4,1,6,VEGA51,1006,3/29/22
7376,1,4,1,6,VEGA52,1009,3/29/22
7377,3,6,2,11,ETCH41,1018,3/29/22
7378,1,6,1,8,ETCH42,1021,3/29/22
7379,0,6,2,8,PHNTM45,1024,3/29/22
7380,2,6,0,8,POST61,1027,3/29/22
7381,1,4,2,7,POST62,1030,3/29/22
7382,2,6,0,8,SMALL41,1033,3/29/22
7383,1,6,0,7,DRAGN28,1039,3/29/22
7384,0,6,4,10,HOOK21,1042,3/29/22
7385,0,4,0,4,DRAGN22,1036,3/29/22
7386,2,4,1,7,BALL72,1103,3/29/22
7387,0,6,2,8,BALL56,1100,3/29/22
7388,2,6,1,9,GOLEM11,1051,3/29/22
7389,2,6,3,11,GOLEM12,1054,3/29/22
7390,2,6,2,10,SLOW11,1142,3/29/22
7391,2,6,2,10,SLOW12,1145,3/29/22
7392,1,2,1,4,BALL89,1151,3/29/22
7393,1,5,2,8,STAB11,1154,3/29/22
7394,1,5,2,8,STAB12,1157,3/29/22
7395,1,2,1,4,HANG51,1200,3/29/22
7396,1,2,5,8,HANG52,1203,3/29/22
7397,2,6,0,8,GIZMO21,1206,3/29/22
7398,2,6,1,9,GIZMO22,1209,3/29/22
7399,2,4,4,10,DRAGN48,1212,3/29/22
7400,1,3,2,6,DRAGN39,1218,3/29/22
7401,3,4,3,10,TORA11,1148,3/29/22
7402,3,4,5,12,TORA12,1151,3/29/22
7403,2,4,3,9,HOOK37,1215,3/29/22
7404,2,3,3,8,DRAGN34,1221,3/29/22
7405,1,3,0,4,HOOK59,1227,3/29/22
7406,2,6,2,10,HOOK03,1348,3/29/22
7407,3,5,0,8,SMALL22,1242,3/29/22
7408,3,5,0,8,SMALL23,1245,3/29/22
7409,2,6,1,9,RECON09,1230,3/29/22
7410,2,3,1,6,RENO71,1233,3/29/22
7411,2,3,1,6,RENO72,1236,3/29/22
7412,1,5,4,10,LOOT06,1239,3/29/22
7413,2,5,0,7,SMALL30,1300,3/29/22
7414,1,4,5,10,POST61,1248,3/29/22
7415,1,4,2,7,POST62,1251,3/29/22
7416,0,0,0,0,WIRE,0,3/29/22
7417,2,4,6,12,WIRE31,1254,3/29/22
7418,2,6,6,14,WIRE32,1257,3/29/22
7419,1,6,2,9,CREEP31,1309,3/29/22
7420,1,6,1,8,CREEP32,13090,3/29/22
7421,1,3,1,5,OUZO11,1315,3/29/22
7422,1,3,1,5,OUZO12,13180,3/29/22
7423,0,5,2,7,DRAGN62,13270,3/29/22
7424,1,3,2,6,AXLE11,1330,3/29/22
7425,2,3,4,9,SHINR81,1321,3/29/22
7426,2,3,1,6,SHINR82,13240,3/29/22
7427,4,4,0,8,BALL76,13360,3/29/22
7428,3,6,1,10,SMALL45,1339,3/29/22
7429,3,6,1,10,SMALL46,1342,3/29/22
7430,1,6,3,10,DRAGN77,1345,3/29/22
7431,2,6,1,9,TORA21,1430,3/29/22
7432,1,6,2,9,TORA22,1430,3/29/22
7433,1,7,2,10,GIZMO11,1454,3/29/22
7434,1,6,6,13,GIZMO12,1457,3/29/22
7435,2,6,1,9,SMALL12,15180,3/29/22
7436,2,5,2,9,SMALL11,1515,3/29/22
7437,0,5,2,7,DRAGN68,1512,3/29/22
7438,2,5,1,8,SMALL13,1521,3/29/22
7439,2,5,1,8,SMALL14,1524,3/29/22
7440,3,5,0,8,SMALL22,1542,3/29/22
7441,2,5,0,7,SMALL26,1554,3/29/22
7442,2,5,0,7,SMALL24,1548,3/29/22
7443,1,6,3,10,CRAZE69,1545,3/29/22
7444,1,3,2,6,DRAGN83,1551,3/29/22
7445,1,4,2,7,DRAGN22,1539,3/29/22
7446,1,5,3,9,STAB11,1545,3/29/22
7447,3,5,1,9,STAB11,1545,3/29/22
7448,1,3,2,6,DRAGN32,1557,3/29/22
7449,1,5,4,10,DRAGN37,1600,3/29/22
7450,2,3,1,6,DRAGN39,1603,3/29/22
7451,2,6,0,8,DRAGN36,1606,3/29/22
7452,2,5,1,8,BADGR04,836,3/30/22
7453,2,6,2,10,badgr05,830,3/30/22
7454,0,5,5,10,hook66,1021,3/30/22
7455,1,5,4,10,ammo08,845,3/30/22
7456,1,5,2,8,recon71,842,3/30/22
7457,2,7,1,10,craze76,851,3/30/22
7458,2,5,3,10,badgr03,833,3/30/22
7459,1,6,1,8,wire31,903,3/30/22
7460,2,6,0,8,recon09,848,3/30/22
7461,2,5,1,8,small76,854,3/30/22
7462,0,7,0,7,paws43,921,3/30/22
7463,1,6,2,9,post61,924,3/30/22
7464,2,5,2,9,small16,930,3/30/22
7465,0,5,0,5,dragn71,939,3/30/22
7466,0,6,1,7,fury02,933,3/30/22
7467,0,5,1,6,dragn69,1009,3/30/22
7468,1,4,0,5,craze47,948,3/30/22
7469,1,3,0,4,easy42,940,3/30/22
7470,1,5,1,7,coach21,957,3/30/22
7471,1,7,4,12,dragn72,951,3/30/22
7472,2,5,2,9,dragn31,1003,3/30/22
7473,2,6,1,9,craze79,1006,3/30/22
7474,2,8,0,10,small40,1024,3/30/22
7475,2,6,3,11,dragn61,1015,3/30/22
7476,1,5,1,7,dragn62,1018,3/30/22
7477,2,5,0,7,small34,1012,3/30/22
7478,2,6,6,14,reno71,1027,3/30/22
7479,1,6,3,10,vega21,1033,3/30/22
7480,1,5,2,8,etch41,1045,3/30/22
7481,2,4,1,7,lost42,1042,3/30/22
7482,1,5,2,8,axle11,1051,3/30/22
7483,1,3,2,6,taunt 51,1100,3/30/22
7484,0,6,4,10,TORA21,1200,3/30/22
7485,1,6,1,8,DRAGN83,1206,3/30/22
7486,0,6,4,10,TORA22,1203,3/30/22
7487,1,5,2,8,DRAGN33,1212,3/30/22
7488,1,5,2,8,DRAGN38,1221,3/30/22
7489,1,6,1,8,DRAGN22,1209,3/30/22
7490,4,6,1,11,SHINR81,1215,3/30/22
7491,1,6,0,7,SHINR82,1218,3/30/22
7492,1,5,2,8,DRAGN39,1227,3/30/22
7493,4,6,3,13,BADGR05,1230,3/30/22
7494,4,6,2,12,CRAZE54,1233,3/30/22
7495,4,6,1,11,FURY04,1239,3/30/22
7496,0,5,2,7,BALL89,1245,3/30/22
7497,1,5,0,6,GOLEM21,1315,3/30/22
7498,1,5,2,8,GOLEM22,1318,3/30/22
7499,2,2,2,6,LOOT55,1242,3/30/22
7500,0,4,4,8,DRAGN91,1427,3/30/22
7501,0,3,2,5,DRAGN71,1515,3/30/22
7502,0,7,5,12,DRAGN66,1524,3/30/22
7503,0,5,3,8,BALL61,1530,3/30/22
7504,1,6,4,11,PHNTM45,1533,3/30/22
7505,0,5,3,8,DRAGN61,1539,3/30/22
7506,1,7,5,13,STAB11,1545,3/30/22
7507,1,7,6,14,STAB12,1548,3/30/22
7508,0,5,4,9,DRAGN69,1527,3/30/22
7509,1,7,5,13,WIRE31,1551,3/30/22
7510,1,7,2,10,WIRE32,1554,3/30/22
7511,0,5,1,6,DRAGN36,1612,3/30/22
7512,1,5,1,7,DRAGN24,1600,3/30/22
7513,0,5,3,8,HOOK05,1609,3/30/22
7514,1,6,2,9,HANG51,1603,3/30/22
7515,1,6,2,9,HANG52,1606,3/30/22
7516,5,6,1,12,SHINR81,1624,3/30/22
7517,2,6,0,8,SHINR82,1627,3/30/22
7518,1,4,3,8,BALL56,1521,3/30/22
7519,1,0,1,2,DRAGN22,1618,3/30/22
7520,1,5,4,10,DRAGN21,1615,3/30/22
7521,1,5,2,8,DRAGN83,1621,3/30/22
7522,1,6,5,12,BALL51,1518,3/30/22
7523,0,6,3,9,DRAGN38,1648,3/30/22
7524,1,5,1,7,DRAGN32,1639,3/30/22
7525,1,5,2,8,DRAGN37,1642,3/30/22
7526,2,6,3,11,DRAGN39,1645,3/30/22
7527,1,6,3,10,CREEP31,1812,3/30/22
7528,1,6,2,9,CREEP32,1815,3/30/22
7529,2,3,3,8,ball42,2000,3/30/22
7530,1,5,1,7,craze13,2003,3/30/22
7531,2,2,1,5,ball44,1957,3/30/22
7532,1,6,1,8,ball41,1954,3/30/22
7533,4,4,1,9,ammo04,2009,3/30/22
7534,4,4,1,9,badgr09,2006,3/30/22
7535,1,4,5,10,AMMO 02,745,3/31/22
7536,4,5,5,14,BADGR 01,739,3/31/22
7537,3,3,4,10,AMMO 09,748,3/31/22
7538,4,6,3,13,RECON 04,736,3/31/22
7539,1,3,3,7,BADGR 08,742,3/31/22
7540,1,3,3,7,CRAZE 76,751,3/31/22
7541,3,4,6,13,BALL 18,757,3/31/22
7542,1,4,3,8,LOOT 06,754,3/31/22
7543,4,5,6,15,STAB 11,812,3/31/22
7544,1,5,3,9,STAB 12,815,3/31/22
7545,2,3,5,10,WIRE 31,818,3/31/22
7546,2,2,5,9,WIRE 32,821,3/31/22
7547,2,5,6,13,CRAZE 46,830,3/31/22
7548,1,5,5,11,RENO 71,824,3/31/22
7549,1,5,5,11,RENO 72,827,3/31/22
7550,2,5,4,11,SPECK 53,839,3/31/22
7551,0,3,1,4,DRAGN 03,912,3/31/22
7552,2,2,1,5,RHINO 55,900,3/31/22
7553,2,4,0,6,CRAZE 79,900,3/31/22
7554,2,4,4,10,PAWS 43,845,3/31/22
7555,0,5,3,8,RECON 08,906,3/31/22
7556,1,4,0,5,CRAZE 21,909,3/31/22
7557,0,4,4,8,DRAGN 71,924,3/31/22
7558,1,4,4,9,HOOK 46,918,3/31/22
7559,2,5,2,9,SLOW 21,945,3/31/22
7560,2,5,2,9,SLOW 22,948,3/31/22
7561,1,3,4,8,DRAGN 38,915,3/31/22
7562,0,6,3,9,DRAGN 72,936,3/31/22
7563,0,4,2,6,CRAZE 47,933,3/31/22
7564,1,5,4,10,DRAGN39,942,3/31/22
7565,0,5,4,9,DRAGN 66,951,3/31/22
7566,1,5,1,7,DRAGN 68,957,3/31/22
7567,0,3,1,4,DRAGN 99,1059,3/31/22
7568,0,3,1,4,BALL 88,939,3/31/22
7569,0,3,1,4,Taut52,1106,3/31/22
7570,2,7,4,13,hang51,1115,3/31/22
7571,2,7,1,10,Hang51,1118,3/31/22
7572,1,5,5,11,Tora11,1121,3/31/22
7573,1,5,3,9,Tora11,1121,3/31/22
7574,2,5,1,8,slow11,1127,3/31/22
7575,1,5,0,6,slow11,1130,3/31/22
7576,1,4,3,8,Dragn22,1139,3/31/22
7577,1,5,2,8,Dragn37,1145,3/31/22
7578,1,6,1,8,Dragn24,1133,3/31/22
7579,1,4,0,5,Dragn28,1136,3/31/22
7580,1,5,2,8,Dragn31,1142,3/31/22
7581,0,5,3,8,craze33,1148,3/31/22
7582,1,4,1,6,dragn36,1151,3/31/22
7583,2,5,1,8,badgr04,1157,3/31/22
7584,3,6,6,15,Vega21,1206,3/31/22
7585,1,6,1,8,vega21,1209,3/31/22
7586,1,5,3,9,ammo01,1230,3/31/22
7587,1,7,4,12,shiner81,1212,3/31/22
7588,1,7,5,13,shiner82,1215,3/31/22
7589,1,5,3,9,recon87,1224,3/31/22
7590,2,6,9,17,Ammo08,1227,3/31/22
7591,1,5,1,7,reno71,1251,3/31/22
7592,2,5,7,14,reno72,1254,3/31/22
7593,1,5,7,13,spot91,1233,3/31/22
7594,1,5,3,9,spot92,1236,3/31/22
7595,1,5,2,8,stab11,1242,3/31/22
7596,1,5,4,10,stab12,1245,3/31/22
7597,2,5,3,10,craze76,1221,3/31/22
7598,1,6,8,15,creep31,1257,3/31/22
7599,1,6,2,9,creep32,1300,3/31/22
7600,1,5,1,7,etch41,1306,3/31/22
7601,1,5,1,7,etch42,1309,3/31/22
7602,0,5,3,8,paws34,1303,3/31/22
7603,0,5,4,9,dragn03,1312,3/31/22
7604,2,5,3,10,coach21,1321,3/31/22
7605,2,5,2,9,coach22,1324,3/31/22
7606,1,4,1,6,ammo04,1327,3/31/22
7607,1,4,1,6,dragn11,1315,3/31/22
7608,2,7,1,10,badgr03,1318,3/31/22
7609,0,4,4,8,ball89,1333,3/31/22
7610,0,4,4,8,ball56,1230,3/31/22
7611,1,4,5,10,schre18,1415,3/31/22
7612,1,4,1,6,lost81,1403,3/31/22
7613,1,4,0,5,lost82,1406,3/31/22
7614,3,5,2,10,slow11,1415,3/31/22
7615,2,5,6,13,slow12,1418,3/31/22
7616,3,7,1,11,dragn75,1430,3/31/22
7618,3,4,2,9,SMALL71,1439,3/31/22
7619,3,4,1,8,SMALL73,1445,3/31/22
7620,2,4,1,7,SMALL67,1433,3/31/22
7621,4,4,3,11,DRAGN65,1436,3/31/22
7622,0,4,3,7,DRAGN71,1418,3/31/22
7623,1,4,4,9,SCARE12,1454,3/31/22
7624,0,5,1,6,FURY02,1451,3/31/22
7625,2,4,0,6,SMALL05,1503,3/31/22
7626,1,5,1,7,RENO71,1509,3/31/22
7627,1,5,2,8,RENO72,1512,3/31/22
7628,2,4,0,6,SMALL06,1506,3/31/22
7629,0,3,1,4,PHNTM77,1442,3/31/22
7630,1,5,1,7,VEGA21,1457,3/31/22
7631,3,5,1,9,VEGA22,1500,3/31/22
7632,2,5,5,12,DRAGN37,1515,3/31/22
7633,2,1,0,3,SMALL13,1521,3/31/22
7634,1,4,2,7,DRAGN33,1527,3/31/22
7635,2,4,2,8,DRAGN36,1518,3/31/22
7636,1,0,2,3,DRAGN83,1530,3/31/22
7637,0,4,4,8,BALL42,1542,3/31/22
7638,1,3,0,4,DRAGN22,1533,3/31/22
7639,2,4,1,7,GOLEM21,1536,3/31/22
7640,2,4,3,9,GOLEM22,1539,3/31/22
7641,1,2,2,5,HANG51,1548,3/31/22
7642,1,2,2,5,HANG52,1551,3/31/22
7643,2,3,3,8,DRAGN17,1554,3/31/22
7644,1,4,8,13,BALL41,1545,3/31/22
7645,4,3,3,10,BADGR04,730,4/1/22
7646,2,1,3,6,BADGR03,733,4/1/22
7647,1,1,5,7,PHNTM77,736,4/1/22
7648,2,2,2,6,BADGR08,739,4/1/22
7649,1,2,4,7,CRAZE54,742,4/1/22
7650,4,3,1,8,RECON04,745,4/1/22
7651,0,3,1,4,BALL89,754,4/1/22
7652,2,2,6,10,BADGR09,748,4/1/22
7653,4,2,7,13,BADGR01,751,4/1/22
7654,1,2,4,7,LOOT06,757,4/1/22
7655,1,2,2,5,AMMO05,800,4/1/22
7656,1,2,4,7,CRAZE76,803,4/1/22
7657,3,2,2,7,BALL71,806,4/1/22
7658,1,5,3,9,BALL37,809,4/1/22
7659,1,3,8,12,VEGA21,824,4/1/22
7660,1,3,4,8,VEGA22,827,4/1/22
7661,1,2,4,7,Axel11,818,4/1/22
7662,3,2,3,8,Axel12,818,4/1/22
7663,1,5,4,10,PAWS34,812,4/1/22
7664,0,2,1,3,AMMO01,833,4/1/22
7665,2,3,5,10,GOLEM41,836,4/1/22
7666,2,3,3,8,GOLEM42,839,4/1/22
7667,1,5,1,7,RECON81,900,4/1/22
7668,1,5,3,9,BALL69,857,4/1/22
7669,2,3,4,9,TORA21,845,4/1/22
7670,2,3,4,9,TORA22,848,4/1/22
7671,0,4,2,6,PAWS13,854,4/1/22
7672,2,3,2,7,PAWS16,903,4/1/22
7673,1,2,8,11,COACH21,906,4/1/22
7674,1,2,4,7,COACH22,909,4/1/22
7675,3,2,1,6,SMALL15,927,4/1/22
7676,3,2,2,7,SMALL14,924,4/1/22
7677,3,2,1,6,SMALL13,921,4/1/22
7678,2,3,2,7,BALL65,930,4/1/22
7679,0,3,2,5,PAWS43,912,4/1/22
7680,1,3,1,5,SHINR81,930,4/1/22
7681,1,3,3,7,SHINR82,933,4/1/22
7682,1,2,2,5,POST61,939,4/1/22
7683,1,2,0,3,POST62,942,4/1/22
7684,2,3,0,5,WIRE31,945,4/1/22
7685,3,3,2,8,WIRE32,948,4/1/22
7686,1,1,2,4,AXLE11,1030,4/1/22
7687,1,1,4,6,AXLE12,1033,4/1/22
7688,0,1,0,1,HOOK59,1215,4/1/22
7689,0,0,0,0,DRAGN91,1303,4/1/22
7690,0,0,2,2,BUBO32,1212,4/1/22
7691,0,0,6,6,GRADN54,1218,4/1/22
7692,1,1,0,2,STAB11,1224,4/1/22
7693,1,1,2,4,STAB12,1227,4/1/22
7694,0,1,1,2,DRAGN03,1236,4/1/22
7695,5,3,3,11,HOOK52,1221,4/1/22
7696,1,2,0,3,CRAZE55,1230,4/1/22
7697,0,1,0,1,HOOK83,1233,4/1/22
7698,2,3,2,7,HOOK11,1239,4/1/22
7699,3,2,4,9,HOOK75,1245,4/1/22
7700,1,2,6,9,DRAGN72,1248,4/1/22
7701,3,2,0,5,HOOK99,1251,4/1/22
7702,3,4,1,8,DRAGN06,1257,4/1/22
7703,2,1,2,5,HOOK17,1254,4/1/22
7704,0,0,6,6,DRAGN61,1242,4/1/22
7705,2,5,0,7,HYDRA11,1403,4/1/22
7706,2,5,4,11,HYDRA12,1406,4/1/22
7707,1,3,0,4,CRAZE44,1412,4/1/22
7708,0,3,1,4,PAWS47,1409,4/1/22
7709,0,1,0,1,DRAGN46,1400,4/1/22
7710,3,2,0,5,DRAGN77,1609,4/1/22
7711,0,1,7,8,HOOK21,1612,4/1/22
7712,0,0,2,2,CRAZE88,1545,4/1/22
7713,0,1,2,3,BALL28,1627,4/1/22
7714,2,3,2,7,HOOK31,1606,4/1/22
7715,2,1,0,3,BALL87,1600,4/1/22
7716,0,1,3,4,CRAZE11,1624,4/1/22
7717,0,1,2,3,HOOK48,1433,4/1/22
7718,0,1,5,6,FILL32,1612,4/1/22
7719,2,4,2,8,TORA51,1621,4/1/22
7720,2,4,2,8,TORA52,1624,4/1/22
7721,0,1,4,5,DRAGN52,1615,4/1/22
7722,0,2,4,6,DRAGN62,954,4/4/22
7723,0,3,5,8,DRAGN65,803,4/4/22
7724,0,5,4,9,PHNTM45,806,4/4/22
7725,0,5,9,14,DRAGN66,812,4/4/22
7726,0,5,3,8,DRAGN68,815,4/4/22
7727,1,4,5,10,DRAGN71,818,4/4/22
7728,0,8,4,12,DRAGN72,821,4/4/22
7729,1,2,1,4,RECON89,830,4/4/22
7730,0,6,6,12,DRAGN03,824,4/4/22
7731,2,4,5,11,DRAGN39,827,4/4/22
7732,1,4,1,6,PHNTM14,842,4/4/22
7733,1,2,3,6,PAWS11,845,4/4/22
7734,0,3,3,6,DRAGN83,851,4/4/22
7735,0,4,4,8,DRAGN24,848,4/4/22
7736,1,3,4,8,HOOK91,857,4/4/22
7737,1,3,0,4,CRAZE54,854,4/4/22
7738,1,2,0,3,BALL79,903,4/4/22
7739,0,2,1,3,RHINO99,800,4/4/22
7740,1,3,3,7,DRAGN19,900,4/4/22
7741,4,4,3,11,VEGA21,912,4/4/22
7742,1,4,0,5,VEGA22,915,4/4/22
7743,1,6,1,8,COACH21,933,4/4/22
7744,1,6,1,8,COACH22,933,4/4/22
7745,1,2,1,4,SHINR81,939,4/4/22
7746,1,2,0,3,SHINR82,942,4/4/22
7747,2,3,1,6,BADGR04,951,4/4/22
7748,1,5,1,7,BADGR09,948,4/4/22
7749,2,2,0,4,CRAZE16,957,4/4/22
7750,1,4,1,6,DRAGN31,1006,4/4/22
7751,1,3,0,4,BADGR08,954,4/4/22
7752,0,2,1,3,HOOK48,1018,4/4/22
7753,1,4,2,7,GIZMO11,1012,4/4/22
7754,1,4,1,6,GIZMO12,1012,4/4/22
7755,1,5,2,8,FILL31,1024,4/4/22
7756,1,5,2,8,FILL32,1027,4/4/22
7757,2,2,3,7,SLOW21,1030,4/4/22
7758,1,2,2,5,SLOW22,1033,4/4/22
7759,1,6,2,9,LOST11,1103,4/4/22
7760,1,6,0,7,LOST12,1106,4/4/22
7761,1,3,1,5,TORA11,1109,4/4/22
7762,3,3,3,9,TORA12,1112,4/4/22
7763,0,4,0,4,CRAZE88,1151,4/4/22
7764,1,6,1,8,CRAZE76,1133,4/4/22
7765,1,6,0,7,AMMO01,1139,4/4/22
7766,0,3,1,4,BALL09,1121,4/4/22
7767,1,4,1,6,AXLE11,1045,4/4/22
7768,1,4,0,5,AXLE12,1048,4/4/22
7769,1,4,0,5,GOLEM21,1115,4/4/22
7770,1,4,7,12,GOLEM22,1118,4/4/22
7771,2,6,5,13,AMMO08,1136,4/4/22
7772,1,5,3,9,AMMO05,1139,4/4/22
7773,1,3,1,5,BALL03,1150,4/4/22
7774,1,4,1,6,HANG51,1154,4/4/22
7775,4,4,1,9,HANG52,1157,4/4/22
7776,1,6,1,8,STAB11,1200,4/4/22
7777,4,6,1,11,STAB12,1203,4/4/22
7778,0,2,4,6,CRAZE81,1209,4/4/22
7779,4,3,1,8,SMALL10,1212,4/4/22
7780,1,3,2,6,CRAZE44,1224,4/4/22
7781,1,4,5,10,SHINR81,1218,4/4/22
7782,1,4,6,11,SHINR82,1221,4/4/22
7783,1,5,1,7,VEGA21,1227,4/4/22
7784,1,5,3,9,VEGA22,1230,4/4/22
7785,0,5,3,8,CRAZE11,1236,4/4/22
7786,1,5,1,7,DRAGN33,1239,4/4/22
7787,3,5,3,11,DRAGON83,1245,4/4/22
7788,1,5,2,8,DRAGN22,1248,4/4/22
7789,1,5,3,9,DRAGN99,1251,4/4/22
7790,2,3,2,7,DRAGN91,1303,4/4/22
7791,1,4,1,6,RECON71,1300,4/4/22
7792,2,7,1,10,DRAGN31,1309,4/4/22
7793,1,5,0,6,BALL64,1427,4/4/22
7794,1,6,2,9,PAWS14,1421,4/4/22
7795,2,6,0,8,BALL42,1433,4/4/22
7796,3,7,9,19,DRAGN03,1442,4/4/22
7797,2,9,1,12,RENO71,1442,4/4/22
7798,2,9,2,13,RENO72,1445,4/4/22
7799,1,4,1,6,HANG51,1448,4/4/22
7800,2,4,1,7,HANG52,1451,4/4/22
7801,1,7,1,9,GHOST53,1454,4/4/22
7802,0,6,2,8,LOOT48,1457,4/4/22
7803,1,7,4,12,GHOST69,1500,4/4/22
7804,1,6,1,8,WIRE31,1503,4/4/22
7805,1,6,1,8,WIRE32,1506,4/4/22
7806,1,9,4,14,COACH21,1509,4/4/22
7807,1,9,5,15,COACH22,1512,4/4/22
7808,1,6,6,13,PHNTM69,1518,4/4/22
7809,0,6,3,9,PAWS16,1515,4/4/22
7810,4,4,2,10,AMMO09,1533,4/4/22
7811,1,5,3,9,AXLE11,1548,4/4/22
7812,1,5,2,8,AXLE12,1551,4/4/22
7813,1,8,0,9,ETCH41,1557,4/4/22
7814,1,8,3,12,ETCH42,1600,4/4/22
7815,1,5,1,7,STAB11,1618,4/4/22
7816,1,5,3,9,STAB12,1621,4/4/22
7817,0,6,0,6,BALL88,1603,4/4/22
7818,2,2,3,7,HOOK38,2033,4/4/22
7819,1,5,3,9,BALL19,2000,4/4/22
7820,2,1,2,5,EPIC06,2012,4/4/22
7821,2,2,4,8,BALL31,2000,4/4/22
7822,1,3,1,5,GHOST53,2015,4/4/22
7823,2,7,1,10,EPIC01,2018,4/4/22
7824,1,2,3,6,BALL65,2021,4/4/22
7825,2,3,4,9,SPECK48,2006,4/4/22
7826,1,3,1,5,DRAGN91,912,4/5/22
7827,0,3,2,5,PHNTM69,948,4/5/22
7828,0,4,0,4,HOOK17,957,4/5/22
7829,1,5,0,6,DRAGN99,1000,4/5/22
7830,2,4,1,7,SLOW51,1018,4/5/22
7831,2,4,1,7,SLOW21,1012,4/5/22
7832,0,2,3,5,PAWS11,1003,4/5/22
7833,0,2,3,5,BALL62,1118,4/5/22
7834,1,2,2,5,COACH21,1112,4/5/22
7835,1,2,1,4,COACH22,1112,4/5/22
7836,3,4,0,7,BADGR01,1130,4/5/22
7837,1,1,4,6,TORA21,1130,4/5/22
7838,1,1,3,5,TORA22,1130,4/5/22
7839,1,2,0,3,BADGR08,1133,4/5/22
7840,1,2,1,4,BADGR04,1136,4/5/22
7841,0,2,0,2,BALL72,1115,4/5/22
7842,2,1,1,4,CRAZE16,1139,4/5/22
7843,1,3,0,4,CRAZE541,1142,4/5/22
7844,1,4,2,7,RECON04,1145,4/5/22
7845,0,2,4,6,DRAGN51,1148,4/5/22
7846,0,3,1,4,BALL15,1157,4/5/22
7847,0,3,4,7,DRAGN61,1209,4/5/22
7848,0,4,4,8,PHNTM45,1212,4/5/22
7849,0,0,0,0,CRAZE76,1154,4/5/22
7850,1,3,3,7,CRAZE47,1227,4/5/22
7851,0,2,3,5,DRAGN75,1224,4/5/22
7852,1,2,2,5,DRAGN39,1233,4/5/22
7853,3,1,1,5,SMALL13,1230,4/5/22
7854,1,1,2,4,CRAZE69,1248,4/5/22
7855,2,2,0,4,DRAGN33,1245,4/5/22
7856,0,1,1,2,DRAGN24,1251,4/5/22
7857,2,2,2,6,DRAGN22,1242,4/5/22
7858,1,1,3,5,CREEP31,1306,4/5/22
7859,1,1,2,4,CREEP32,1309,4/5/22
7860,3,3,0,6,SMALL20,1236,4/5/22
7861,3,1,1,5,SMALL13,1230,4/5/22
7862,3,2,1,6,SMALL14,1224,4/5/22
7863,3,2,0,5,SMALL20,1151,4/5/22
7864,4,0,2,6,SMALL26,1254,4/5/22
7865,1,1,5,7,DRAGN66,1406,4/5/22
7866,2,2,3,7,DRAGN68,1409,4/5/22
7867,1,1,1,3,VEGA21,1421,4/5/22
7868,4,1,3,8,VEGA22,1424,4/5/22
7869,4,2,3,9,AXLE11,1427,4/5/22
7870,1,2,1,4,AXLE12,1430,4/5/22
7871,4,0,0,4,SMALL75,1451,4/5/22
7872,4,0,0,4,SMALL74,1448,4/5/22
7873,2,2,2,6,GOLEM31,1436,4/5/22
7874,2,2,1,5,GOLEM32,1439,4/5/22
7875,1,2,1,4,SHINR81,1454,4/5/22
7876,1,2,2,5,SHINR82,1457,4/5/22
7877,1,1,1,3,BALL63,1500,4/5/22
7878,3,1,0,4,SMALL07,1509,4/5/22
7879,3,1,1,5,SMALL13,1521,4/5/22
7880,1,1,0,2,WIRE31,1503,4/5/22
7881,1,1,1,3,WIRE32,1506,4/5/22
7882,0,1,2,3,BADGR04,1512,4/5/22
7883,1,2,3,6,CRAZE16,1515,4/5/22
7884,2,1,0,3,FILL21,1442,4/5/22
7885,2,1,4,7,FILL22,1445,4/5/22
7886,2,1,3,6,BADGR01,1518,4/5/22
7887,3,4,2,9,AMMO09,1539,4/5/22
7888,1,0,3,4,BADGR05,1524,4/5/22
7889,1,1,0,2,STAB11,1548,4/5/22
7890,4,1,1,6,STAB12,1551,4/5/22
7891,0,4,3,7,RECON71,1530,4/5/22
7892,3,3,0,6,SMALL17,1536,4/5/22
7893,3,3,0,6,SMALL20,1536,4/5/22
7894,0,1,1,2,DRAGN47,1554,4/5/22
7895,1,5,1,7,HANG51,1542,4/5/22
7896,4,5,2,11,HANG52,1545,4/5/22
7897,1,1,3,5,POST61,1606,4/5/22
7898,4,1,3,8,POST62,1609,4/5/22
7899,2,2,2,6,BALL25,1930,4/5/22
7900,2,3,3,8,PHNTM48,2006,4/5/22
7901,2,4,4,10,EPIC06,2012,4/5/22
7902,3,5,3,11,SPECK48,2003,4/5/22
7903,2,4,3,9,EPIC01,2009,4/5/22
7904,1,3,2,6,CRAZE47,2021,4/5/22
7905,2,4,4,10,PAWS42,2024,4/5/22
7906,2,4,6,12,HOOK52,2027,4/5/22
7907,0,0,0,0,DRAGN51,0,4/6/22
7908,0,1,3,4,DRAGN51,803,4/6/22
7909,1,5,3,9,SCARE18,815,4/6/22
7910,0,0,6,6,HOOK63,809,4/6/22
7911,0,3,3,6,CRAZE44,824,4/6/22
7912,1,3,2,6,DRAGN31,827,4/6/22
7913,2,3,4,9,DRAGN37,833,4/6/22
7914,0,0,4,4,DRAGN61,812,4/6/22
7915,3,4,2,9,SMALL62,818,4/6/22
7916,4,4,2,10,SMALL63,821,4/6/22
7917,1,3,7,11,DRAGN32,836,4/6/22
7918,1,4,3,8,PHNTM14,839,4/6/22
7919,1,5,5,11,DRAGN36,830,4/6/22
7920,1,4,1,6,CRAZE11,851,4/6/22
7921,3,2,2,7,BALL89,900,4/6/22
7922,1,0,0,1,WIRE31,906,4/6/22
7923,3,3,3,9,BALL81,903,4/6/22
7924,1,0,2,3,STAB11,842,4/6/22
7925,1,0,0,1,STAB12,845,4/6/22
7926,1,3,1,5,CREEP31,918,4/6/22
7927,2,4,3,9,GOLEM21,912,4/6/22
7928,0,3,5,8,BALL04,927,4/6/22
7929,3,4,0,7,SMALL17,933,4/6/22
7930,0,3,0,3,PAWS14,930,4/6/22
7931,2,4,0,6,SLOW11,1012,4/6/22
7932,1,3,0,4,CRAZE54,951,4/6/22
7933,1,3,1,5,CRAZE16,948,4/6/22
7934,3,4,1,8,BADGR09,957,4/6/22
7935,3,2,0,5,BADGR01,954,4/6/22
7936,1,3,1,5,BADGR04,1000,4/6/22
7937,2,1,0,3,PAWS76,1003,4/6/22
7938,2,4,2,8,SLOW41,1009,4/6/22
7939,3,4,5,12,AXLE11,1018,4/6/22
7940,0,3,1,4,COBRA05,1112,4/6/22
7941,1,3,4,8,DRAGN38,1118,4/6/22
7942,0,3,4,7,BALL69,1127,4/6/22
7943,1,5,1,7,SCARE12,1136,4/6/22
7944,2,3,3,8,BALL18,1124,4/6/22
7945,1,3,2,6,HANG51,1130,4/6/22
7946,0,4,0,4,BALL42,1115,4/6/22
7947,1,3,2,6,ETCH41,1148,4/6/22
7948,1,3,0,4,PAWS14,1142,4/6/22
7949,1,4,3,8,DRAGN36,1145,4/6/22
7950,3,4,1,8,LOST11,1100,4/6/22
7951,1,3,1,5,SHINR81,1154,4/6/22
7952,0,4,4,8,CRAZE47,1218,4/6/22
7953,0,4,8,12,DRAGN37,1212,4/6/22
7954,0,3,3,6,CRAZE44,1224,4/6/22
7955,1,2,4,7,DRAGN31,1215,4/6/22
7956,2,4,6,12,DRAGN39,1227,4/6/22
7957,0,2,1,3,PHNTM45,1224,4/6/22
7958,2,3,2,7,DRAGN75,1221,4/6/22
7959,0,4,2,6,DRAGN33,1245,4/6/22
7960,2,1,6,9,HOOK21,1239,4/6/22
7961,0,2,5,7,DRAGN24,1248,4/6/22
7962,1,3,2,6,DRAGN22,1251,4/6/22
7963,0,4,1,5,CRAZE11,1254,4/6/22
7964,1,4,5,10,DRAGN66,1257,4/6/22
7965,4,2,0,6,BALL91,1300,4/6/22
7966,1,4,2,7,TUANT81,1324,4/6/22
7967,1,4,2,7,TUANT82,1327,4/6/22
7968,4,3,8,15,DRAGN32,1418,4/6/22
7969,2,2,2,6,RENO71,1406,4/6/22
7970,2,2,1,5,RENO72,1409,4/6/22
7971,1,5,2,8,GHOST53,1433,4/6/22
7972,0,6,2,8,BALL81,1436,4/6/22
7973,2,4,3,9,GOLEM21,1424,4/6/22
7974,2,4,2,8,GOLEM22,1427,4/6/22
7975,2,7,0,9,RENO21,1439,4/6/22
7976,2,7,1,10,RENO22,1442,4/6/22
7977,1,7,1,9,BALL72,1445,4/6/22
7978,1,6,0,7,WIRE21,1448,4/6/22
7979,1,6,2,9,WIRE22,1451,4/6/22
7980,1,3,1,5,BADGR03,1454,4/6/22
7981,1,3,1,5,BADGR08,1500,4/6/22
7982,3,4,3,10,CRAZE16,1457,4/6/22
7983,0,6,3,9,DRAGN71,1503,4/6/22
7984,1,5,0,6,AMMO01,1512,4/6/22
7985,0,5,1,6,BADGR01,1509,4/6/22
7986,1,4,2,7,PHNATOM77,1515,4/6/22
7987,0,5,0,5,AMMO05,1518,4/6/22
7988,1,5,7,13,AMMO08,1521,4/6/22
7989,0,7,6,13,HOOK51,1530,4/6/22
7990,0,5,4,9,DRAGN53,1539,4/6/22
7991,1,6,2,9,CREEP31,1545,4/6/22
7992,1,6,2,9,CREEP32,1548,4/6/22
7993,1,4,4,9,ETCH41,1615,4/6/22
7994,1,6,3,10,SHINR81,1603,4/6/22
7995,1,6,3,10,SHINR82,1600,4/6/22
7996,2,6,2,10,BALL99,2003,4/6/22
7997,2,6,4,12,BALL41,2006,4/6/22
7998,2,3,2,7,BALL65,2021,4/6/22
7999,1,4,2,7,BALL88,2018,4/6/22
8000,2,4,4,10,BALL72,2024,4/6/22
8001,1,4,3,8,AMMO01,2009,4/6/22
8002,1,4,3,8,LOOT06,2030,4/6/22
8003,2,5,5,12,BALL31,2024,4/6/22
8004,2,7,2,11,BALL38,2033,4/6/22
8005,2,3,2,7,HOOK71,2036,4/6/22
8006,1,5,0,6,Easy86,801,4/7/22
8007,0,5,3,8,DRAGN68,803,4/7/22
8008,1,4,2,7,ETCH41,806,4/7/22
8009,1,4,5,10,ETCH42,806,4/7/22
8010,0,3,2,5,CRAZE47,818,4/7/22
8011,1,6,5,12,DRAGN61,812,4/7/22
8012,0,9,3,12,DRAGN72,830,4/7/22
8013,1,4,2,7,DRAGN31,833,4/7/22
8014,1,6,6,13,DRAGN32,839,4/7/22
8015,2,7,0,9,RHINO99,800,4/7/22
8016,1,3,3,7,HOOK02,1003,4/7/22
8017,1,5,2,8,DRAGN99,851,4/7/22
8018,1,5,4,10,DRAGN36,842,4/7/22
8019,0,7,1,8,CRAZE11,848,4/7/22
8020,0,2,0,2,HOOK91,912,4/7/22
8021,0,8,2,10,DRAGN65,903,4/7/22
8022,1,4,0,5,CRAZE54,909,4/7/22
8023,2,7,1,10,DRAGN83,915,4/7/22
8024,2,7,2,11,TAUNT41,918,4/7/22
8025,2,7,1,10,TAUNT42,918,4/7/22
8026,1,7,3,11,wire31,924,4/7/22
8027,1,7,2,10,wire32,924,4/7/22
8028,0,6,1,7,ball37,933,4/7/22
8029,1,4,1,6,RENO71,942,4/7/22
8030,1,4,1,6,RENO72,942,4/7/22
8031,1,3,1,5,AMMO09,945,4/7/22
8032,1,3,2,6,POST61,954,4/7/22
8033,1,3,1,5,POST62,957,4/7/22
8034,1,6,3,10,AMMO08,948,4/7/22
8035,1,4,2,7,SPECK02,1000,4/7/22
8036,1,5,0,6,TORA11,1018,4/7/22
8037,1,5,1,7,TORA12,1021,4/7/22
8038,0,7,6,13,PAWS42,1024,4/7/22
8039,1,5,4,10,HANG51,1030,4/7/22
8040,1,5,1,7,HANG52,1033,4/7/22
8041,1,4,0,5,STAB11,1309,4/7/22
8042,1,4,1,6,STAB12,1309,4/7/22
8043,0,6,3,9,FURY03,1127,4/7/22
8044,2,6,0,8,LOOT48,1121,4/7/22
8045,0,0,0,0,Manly 31,0,4/7/22
8046,2,7,0,9,MANLY 31,1130,4/7/22
8047,2,7,2,11,MANLY31,1130,4/7/22
8048,1,3,0,4,COACH 21,1142,4/7/22
8049,1,3,0,4,COACH22,1142,4/7/22
8050,0,4,0,4,CRAZE16,1133,4/7/22
8051,1,5,1,7,LOOT06,1154,4/7/22
8052,1,6,1,8,AMMO01,1151,4/7/22
8053,2,5,1,8,GIZMO11,1115,4/7/22
8054,1,4,5,10,GHOST53,1203,4/7/22
8055,0,5,3,8,PHANTM45,1212,4/7/22
8056,1,5,6,12,CREEP31,1206,4/7/22
8057,2,3,8,13,CREEP31,1206,4/7/22
8058,1,3,4,8,HYDRA11,1221,4/7/22
8059,1,3,5,9,HYDRA11,1221,4/7/22
8060,2,4,2,8,HOOK21,1215,4/7/22
8061,1,3,2,6,SASY85,1201,4/7/22
8062,3,6,2,11,EPIC99,1248,4/7/22
8063,0,5,4,9,DRAGN52,1218,4/7/22
8064,0,4,5,9,DRAGN75,1242,4/7/22
8065,0,4,2,6,BALL,1124,4/7/22
8066,0,4,2,6,BALL89,1257,4/7/22
8067,1,6,4,11,COBRA07,1251,4/7/22
8068,0,4,1,5,BALL88,1254,4/7/22
8069,1,7,2,10,RENO17,1406,4/7/22
8070,1,7,1,9,RENO71,1406,4/7/22
8071,4,3,5,12,DRAGN38,1433,4/7/22
8072,0,5,3,8,DRAGN99,1445,4/7/22
8073,0,5,3,8,PHNTM14,1442,4/7/22
8074,1,5,5,11,DRAGN37,1439,4/7/22
8075,1,5,2,8,DRAGN22,1448,4/7/22
8076,0,8,6,14,DRAGN24,1457,4/7/22
8077,0,6,3,9,PAWS11,1454,4/7/22
8078,2,7,3,12,GOLEM11,1500,4/7/22
8079,2,7,2,11,GOLEM12,1500,4/7/22
8080,2,9,3,14,STAB11,1506,4/7/22
8081,1,9,0,10,STAB12,1506,4/7/22
8082,1,8,2,11,BALL31,1739,4/7/22
8083,0,7,3,10,DRAGN68,809,4/8/22
8084,1,6,6,13,HANG51,800,4/8/22
8085,1,6,7,14,HANG52,803,4/8/22
8086,0,5,7,12,DRAGN66,806,4/8/22
8087,3,2,3,8,CRAZE44,824,4/8/22
8088,0,7,4,11,DRAGN61,812,4/8/22
8089,2,7,2,11,SLOW41,818,4/8/22
8090,1,7,10,18,SLOW42,821,4/8/22
8091,1,5,3,9,DRAGN31,830,4/8/22
8092,1,4,2,7,SHINR81,845,4/8/22
8093,2,4,0,6,SHINR82,848,4/8/22
8094,0,3,4,7,PHANTM14,836,4/8/22
8095,1,4,2,7,DRAGN22,842,4/8/22
8096,4,5,4,13,DRAGN32,833,4/8/22
8097,1,5,5,11,DRAGN37,839,4/8/22
8098,0,5,2,7,DRAGN33,851,4/8/22
8099,1,7,1,9,SCARE17,854,4/8/22
8100,1,5,0,6,EASY18,855,4/8/22
8101,2,5,2,9,GIZMO11,857,4/8/22
8102,2,5,2,9,GIZMO12,857,4/8/22
8103,0,3,2,5,CRAZE47,903,4/8/22
8104,2,5,5,12,TORA11,906,4/8/22
8105,2,5,3,10,TOAR12,906,4/8/22
8106,1,5,3,9,STAB11,912,4/8/22
8107,1,5,0,6,STAB12,912,4/8/22
8108,1,4,4,9,RENO71,924,4/8/22
8109,1,4,0,5,RENO72,927,4/8/22
8110,0,5,0,5,COBRA08,918,4/8/22
8111,0,6,2,8,BALL99,930,4/8/22
8112,3,5,4,12,SPECK53,936,4/8/22
8113,1,3,0,4,VEGA21,936,4/8/22
8114,1,3,0,4,VEGA22,939,4/8/22
8115,1,4,2,7,WIRE31,948,4/8/22
8116,1,4,0,5,WIRE32,948,4/8/22
8117,4,5,2,11,CRAZE12,945,4/8/22
8118,2,4,5,11,BALL51,933,4/8/22
8119,1,5,1,7,SCARE36,954,4/8/22
8120,3,2,2,7,RECON77,957,4/8/22
8121,1,6,1,8,CREEP31,1000,4/8/22
8122,1,6,2,9,CREEP32,1003,4/8/22
8123,3,4,2,9,BALL69,1009,4/8/22
8124,1,5,0,6,CRAZE54,1012,4/8/22
8125,1,3,1,5,CRAZE16,1021,4/8/22
8126,1,3,2,6,BADGR01,1015,4/8/22
8127,1,3,1,5,BADGR09,1018,4/8/22
8128,2,6,1,9,SLOW21,1024,4/8/22
8129,2,6,1,9,SLOW22,1027,4/8/22
8130,2,4,1,7,SLOW31,1030,4/8/22
8131,1,4,0,5,SLOW32,1033,4/8/22
8132,0,4,6,10,GHOST02,1109,4/8/22
8133,1,5,2,8,LOOT48,1106,4/8/22
8134,0,5,1,6,PHNTM77,1112,4/8/22
8135,1,4,0,5,LOST11,1100,4/8/22
8136,1,4,0,5,LOST12,1103,4/8/22
8137,1,3,1,5,ETCH41,1130,4/8/22
8138,0,4,1,5,LOOT06,1115,4/8/22
8139,3,4,0,7,CRAZE76,1121,4/8/22
8140,2,5,2,9,SLOW51,1139,4/8/22
8141,1,5,0,6,SLOW52,1142,4/8/22
8142,1,3,1,5,AMMO05,1124,4/8/22
8143,3,4,4,11,BALL18,1127,4/8/22
8144,0,4,2,6,PHNTM03,1136,4/8/22
8145,2,4,7,13,HOOK66,1148,4/8/22
8146,3,4,3,10,DRAGN71,1200,4/8/22
8147,1,4,2,7,SCARE76,1157,4/8/22
8148,1,5,2,8,SCARE29,1154,4/8/22
8149,0,4,3,7,CRAZE33,1215,4/8/22
8150,3,4,7,14,DRAGN37,1206,4/8/22
8151,1,3,5,9,DRAGN61,1221,4/8/22
8152,1,3,4,8,AMMO01,1233,4/8/22
8153,0,4,5,9,DRAGN22,1218,4/8/22
8154,2,4,0,6,DRAGN91,1236,4/8/22
8155,1,3,3,7,PHNTM14,1227,4/8/22
8156,0,3,4,7,DRAGN33,1230,4/8/22
8157,1,3,1,5,BADGR04,1245,4/8/22
8158,3,4,5,12,BALL38,1212,4/8/22
8159,3,4,5,12,AXLE11,1251,4/8/22
8160,1,4,4,9,AXLE,12,4/8/22
8161,2,3,2,7,RENO71,1300,4/8/22
8162,2,3,1,6,RENO72,1303,4/8/22
8163,0,3,2,5,COBRA05,1309,4/8/22
8164,1,1,2,4,BALL44,1257,4/8/22
8165,0,4,1,5,RECON89,1312,4/8/22
8166,1,1,4,6,COACH21,1415,4/8/22
8167,1,1,2,4,COACH22,1421,4/8/22
8168,1,1,1,3,VEGA21,1409,4/8/22
8169,1,1,6,8,VEGA22,1412,4/8/22
8170,2,3,5,10,DRAGN38,1424,4/8/22
8171,2,1,4,7,CRAZE12,1427,4/8/22
8172,1,5,2,8,POST61,1430,4/8/22
8173,1,5,1,7,POST62,14310,4/8/22
8174,0,2,1,3,BADGR03,1421,4/8/22
8175,1,1,4,6,PHNTM69,1448,4/8/22
8176,1,6,1,8,BADGR08,1451,4/8/22
8177,1,5,2,8,BADGR09,1454,4/8/22
8178,1,4,1,6,BALL62,1436,4/8/22
8179,1,4,4,9,LOOT06,1500,4/8/22
8180,0,4,3,7,PHNTM77,1505,4/8/22
8181,1,3,6,10,AMMO,1512,4/8/22
8182,4,3,2,9,BALL15,1509,4/8/22
8183,1,6,3,10,GIZMO51,1518,4/8/22
8184,1,6,1,8,GIZMO52,1518,4/8/22
8185,0,4,2,6,SPECK69,1445,4/8/22
8186,0,5,1,6,BALL84,1533,4/8/22
8187,0,5,1,6,BALL85,1536,4/8/22
8188,0,1,0,1,BALL63,1530,4/8/22
8189,1,4,0,5,BALL88,1530,4/8/22
8190,0,3,6,9,HOOK66,1515,4/8/22
8191,0,4,1,5,LOOT45,1700,4/8/22
8192,3,1,2,6,HOOK21,1527,4/8/22
8193,0,2,5,7,DRAGN69,818,4/11/22
8194,2,4,1,7,LOST11,1200,4/10/22
8195,1,4,2,7,LOST12,1203,4/10/22
8196,1,7,2,10,HOOK71,1406,4/10/22
8197,1,5,0,6,TORA11,1212,4/10/22
8198,0,7,0,7,BALL19,1218,4/10/22
8199,3,5,1,9,GOLEM11,1206,4/11/22
8200,1,6,6,13,DRAGN71,803,4/11/22
8201,0,6,2,8,DRAGN68,815,4/11/22
8202,0,4,4,8,CRAZE86,824,4/11/22
8203,1,5,4,10,SCARE77,833,4/11/22
8204,3,7,5,15,HOOK66,812,4/11/22
8205,0,1,4,5,DRAGN65,821,4/11/22
8206,1,3,7,11,DRAGN37,827,4/11/22
8207,1,3,3,7,DRAGN31,836,4/11/22
8208,2,5,7,14,DRAGN38,830,4/11/22
8209,0,4,4,8,DRAGN24,845,4/11/22
8210,4,3,1,8,SMALL71,839,4/11/22
8211,0,4,0,4,RHINO99,830,4/11/22
8212,3,3,1,7,SMALL72,842,4/11/22
8213,4,3,2,9,SMALL74,848,4/11/22
8214,4,5,2,11,SMALL56,806,4/11/22
8215,3,3,1,7,SMALL75,851,4/11/22
8216,1,3,1,5,RECON81,900,4/11/22
8217,1,5,0,6,CRAZE54,857,4/11/22
8218,1,3,2,6,DRAGN22,854,4/11/22
8219,2,4,0,6,DRAGN83,906,4/11/22
8220,3,6,0,9,SMALL11,915,4/11/22
8221,1,4,0,5,STAB11,918,4/11/22
8222,4,4,0,8,STAB12,921,4/11/22
8223,2,6,4,12,HANG51,927,4/11/22
8224,2,6,3,11,HANG52,930,4/11/22
8225,2,6,3,11,DRAGN48,924,4/11/22
8226,1,6,4,11,ETCH41,933,4/11/22
8227,1,6,2,9,ETCH42,936,4/11/22
8228,1,3,1,5,WIRE31,939,4/11/22
8229,1,3,1,5,WIRE32,942,4/11/22
8230,1,4,0,5,STAB11,918,4/11/22
8231,1,4,4,9,STAB12,921,4/11/22
8232,3,2,1,6,CREEP31,912,4/11/22
8233,3,2,0,5,CREEP32,915,4/11/22
8234,1,2,1,4,VEGA21,957,4/11/22
8235,1,2,0,3,VEGA22,1000,4/11/22
8236,1,1,5,7,COACH21,951,4/11/22
8237,1,1,0,2,COACH22,954,4/11/22
8238,2,3,1,6,SLOW31,1015,4/11/22
8239,1,3,0,4,SLOW32,1018,4/11/22
8240,0,1,2,3,HOOK03,1003,4/11/22
8241,1,0,3,4,PAWS47,1006,4/11/22
8242,2,4,1,7,TORA11,1021,4/11/22
8243,2,4,3,9,TORA12,1024,4/11/22
8244,1,3,2,6,LOST51,1009,4/11/22
8245,1,3,4,8,LOST52,1012,4/11/22
8246,0,0,4,4,AMMO02,1033,4/11/22
8247,0,1,4,5,CRAZE25,1036,4/11/22
8248,3,4,0,7,SMALL45,1039,4/11/22
8249,3,4,0,7,SMALL47,1045,4/11/22
8250,1,5,1,7,GOLEM21,1103,4/11/22
8251,1,5,2,8,GOLEM22,1106,4/11/22
8252,4,2,1,7,SMALL46,1042,4/11/22
8253,0,0,0,0,PAWS,1109,4/11/22
8254,1,1,1,3,PAWS14,1109,4/11/22
8255,1,5,2,8,TAUNT11,1112,4/11/22
8256,1,5,1,7,TUANT12,1115,4/11/22
8257,1,3,4,8,TORA21,1118,4/11/22
8258,2,3,1,6,TORA21,1121,4/11/22
8259,0,1,0,1,COBRA08,1124,4/11/22
8260,0,2,3,5,BADGR01,1133,4/11/22
8261,3,5,3,11,RECON04,1130,4/11/22
8262,3,1,2,6,BALL24,1136,4/11/22
8263,1,1,1,3,RECON89,1145,4/11/22
8264,3,2,1,6,BADGR05,1139,4/11/22
8265,1,3,3,7,PHNTM77,1142,4/11/22
8266,1,0,1,2,CRAZE16,1148,4/11/22
8267,0,0,0,0,PAWS88,1200,4/11/22
8268,0,3,2,5,PAWS12,1154,4/11/22
8269,1,0,4,5,PHNTM69,1151,4/11/22
8270,3,3,3,9,SMALL77,1157,4/11/22
8271,1,1,0,2,WIRE31,1206,4/11/22
8272,4,1,0,5,WIRE32,1209,4/11/22
8273,0,3,6,9,DRAGN71,1218,4/11/22
8274,3,1,1,5,BALL11,1200,4/11/22
8275,0,1,3,4,RECON82,1215,4/11/22
8276,3,3,1,7,SMALL14,1224,4/11/22
8277,0,6,5,11,HOOK69,1233,4/11/22
8278,0,3,5,8,PHNTM45,1230,4/11/22
8279,0,1,4,5,CRAZE86,1227,4/11/22
8280,0,3,3,6,DRAGN72,1221,4/11/22
8281,2,5,9,16,DRAGN38,1242,4/11/22
8282,4,3,6,13,HOOK61,1236,4/11/22
8283,1,2,4,7,DRAGN31,1248,4/11/22
8284,0,3,6,9,DRAGN36,1239,4/11/22
8285,0,0,4,4,DRAGN21,1300,4/11/22
8286,1,1,2,4,DRAGN91,1342,4/11/22
8287,2,2,3,7,DRAGN99,1330,4/11/22
8288,1,4,2,7,EASY85,1320,4/11/22
8289,0,5,4,9,DRAGN22,1333,4/11/22
8290,1,4,3,8,SHINR81,1336,4/11/22
8291,1,4,2,7,SHINR82,1339,4/11/22
8292,4,5,3,12,ETCH41,1430,4/11/22
8293,1,5,2,8,ETCH42,1433,4/11/22
8294,1,5,4,10,CREEP31,1442,4/11/22
8295,1,5,1,7,CREEP32,1445,4/11/22
8296,1,4,1,6,EASY86,1400,4/11/22
8297,1,5,2,8,HANG51,1448,4/11/22
8298,2,5,4,11,HANG52,1451,4/11/22
8299,2,5,1,8,SPECK69,1457,4/11/22
8300,2,4,5,11,FURY01,1454,4/11/22
8301,1,5,2,8,PHNTM48,1509,4/11/22
8302,0,5,2,7,BALL41,1503,4/11/22
8303,1,4,4,9,AMMO02,1521,4/11/22
8304,2,6,0,8,Axle 11,1512,4/11/22
8305,1,6,3,10,Axle12,1515,4/11/22
8306,0,5,4,9,CRAZE42,1518,4/11/22
8307,2,4,5,11,AMMO08,1524,4/11/22
8308,0,4,0,4,AMMO09,1527,4/11/22
8309,0,5,1,6,LOOT50,1600,4/11/22
8310,2,4,1,7,BALL38,1627,4/11/22
8311,2,4,1,7,RECON87,1636,4/11/22
8312,1,4,3,8,VEGA21,1642,4/11/22
8313,1,5,1,7,VEGA22,1645,4/11/22
8314,0,5,5,10,PAWS77,806,4/12/22
8315,0,4,9,13,HOOK66,812,4/12/22
8316,2,4,3,9,STAB11,818,4/12/22
8317,1,4,1,6,STAB12,821,4/12/22
8318,2,6,4,12,RENO71,800,4/12/22
8319,1,6,2,9,RENO72,803,4/12/22
8320,1,3,5,9,DRAGN38,824,4/12/22
8321,1,3,5,9,DRAGN37,8270,4/12/22
8322,1,4,6,11,DRAGN91,900,4/12/22
8323,0,3,3,6,DRAGN83,845,4/12/22
8324,1,2,1,4,RECON89,851,4/12/22
8325,2,1,1,4,CRAZE79,833,4/12/22
8326,0,2,1,3,DRAGN69,903,4/12/22
8327,0,3,1,4,RECON69,854,4/12/22
8328,1,5,5,11,AXLE11,906,4/12/22
8329,1,5,1,7,AXLE12,909,4/12/22
8330,3,4,2,9,TAUNT11,839,4/12/22
8331,1,4,3,8,TAUNT12,842,4/12/22
8332,1,3,3,7,HANG51,912,4/12/22
8333,1,3,0,4,HANG52,915,4/12/22
8334,1,4,1,6,CREEP31,918,4/12/22
8335,1,4,0,5,CREEP32,921,4/12/22
8336,1,4,4,9,WIRE31,924,4/12/22
8337,1,4,1,6,WIRE32,927,4/12/22
8338,0,4,0,4,PAWS48,933,4/12/22
8339,2,6,3,11,CRAZE55,857,4/12/22
8340,1,3,2,6,TORA11,954,4/12/22
8341,1,3,0,4,TORA12,957,4/12/22
8342,1,3,2,6,COACH21,936,4/12/22
8343,1,3,1,5,COACH22,939,4/12/22
8344,1,3,0,4,GIZMO31,1000,4/12/22
8345,1,3,3,7,GIZMO32,1003,4/12/22
8346,1,2,2,5,SHINR81,942,4/12/22
8347,1,2,1,4,SHINR82,945,4/12/22
8348,1,2,2,5,MANLY21,1018,4/12/22
8349,0,2,1,3,HOOK68,1006,4/12/22
8350,0,4,2,6,PHNTM45,1039,4/12/22
8351,1,4,1,6,DRAGN02,1024,4/12/22
8352,3,4,3,10,PAWS47,1012,4/12/22
8353,1,4,3,8,POST61,1048,4/12/22
8354,1,4,2,7,POST62,1051,4/12/22
8355,1,1,0,2,GOLEM21,1100,4/12/22
8356,1,1,1,3,GOLEM22,1103,4/12/22
8357,1,4,3,8,TORA21,1121,4/12/22
8358,1,4,1,6,TORA22,1124,4/12/22
8359,2,3,0,5,RENO71,1133,4/12/22
8360,2,3,3,8,RENO72,1136,4/12/22
8361,0,2,1,3,BALL65,1130,4/12/22
8362,2,1,3,6,BALL41,1127,4/12/22
8363,0,3,4,7,PAWS12,1130,4/12/22
8364,2,4,2,8,TORA31,1109,4/12/22
8365,2,4,3,9,TORA32,1112,4/12/22
8366,2,2,2,6,GOLEM11,1139,4/12/22
8367,2,2,2,6,GOLEM12,1142,4/12/22
8368,0,4,4,8,DRAGN75,1151,4/12/22
8369,0,2,4,6,DRAGN62,1203,4/12/22
8370,0,3,3,6,BALL44,1118,4/12/22
8371,0,1,2,3,CRAZE86,1206,4/12/22
8372,0,3,6,9,DRAGN72,1154,4/12/22
8373,0,1,4,5,CRAZE66,1209,4/12/22
8374,2,4,6,12,DRAGN65,1200,4/12/22
8375,0,4,3,7,BALL31,1148,4/12/22
8376,0,3,2,5,CRAZE15,1145,4/12/22
8377,0,2,7,9,DRAGN37,1212,4/12/22
8378,1,4,4,9,DRAGN36,1215,4/12/22
8379,3,3,1,7,SMALL04,1200,4/12/22
8380,0,2,4,6,DRAGN24,1230,4/12/22
8381,1,1,3,5,HOOK11,1230,4/12/22
8382,1,1,4,6,CRAZE79,1218,4/12/22
8383,1,2,2,5,DRAGN91,1156,4/12/22
8384,0,3,1,4,DRAGN33,1227,4/12/22
8385,3,1,1,5,SMALL22,1242,4/12/22
8386,4,1,1,6,SMALL11,1215,4/12/22
8387,0,1,1,2,DRAGN99,1239,4/12/22
8388,3,5,0,8,SMALL23,1245,4/12/22
8389,1,1,4,6,RECON01,1251,4/12/22
8390,2,1,2,5,DRAGN22,1242,4/12/22
8391,1,2,1,4,SCARE12,1327,4/12/22
8392,1,3,4,8,AXLE11,1330,4/12/22
8393,1,3,2,6,AXLE12,1333,4/12/22
8394,1,1,2,4,WIRE31,1342,4/12/22
8395,1,1,2,4,WIRE32,1345,4/12/22
8396,1,2,3,6,RECON08,1324,4/12/22
8397,1,3,3,7,SHINR81,1348,4/12/22
8398,1,3,3,7,SHINR82,1351,4/12/22
8399,1,2,2,5,CRAZE14,1439,4/12/22
8400,1,4,1,6,BADGR04,1436,4/12/22
8401,0,6,5,11,DRAGN75,912,4/13/22
8402,0,8,4,12,HOOK69,842,4/13/22
8403,3,3,5,11,DRAGN32,845,4/13/22
8404,2,3,4,9,DRAGN21,848,4/13/22
8405,0,3,2,5,DRAGN22,851,4/13/22
8406,1,4,0,5,WIRE31,854,4/13/22
8407,1,4,0,5,WIRE32,857,4/13/22
8408,2,6,3,11,LOOT51,903,4/13/22
8409,0,6,1,7,RECON89,900,4/13/22
8410,1,2,0,3,HOOK06,836,4/13/22
8411,3,1,0,4,SMALL07,909,4/13/22
8412,1,5,2,8,VEGA21,933,4/13/22
8413,1,5,3,9,VEGA22,936,4/13/22
8414,1,4,1,6,FILL31,915,4/13/22
8415,1,4,4,9,FILL32,918,4/13/22
8416,0,5,2,7,DRAGN72,921,4/13/22
8417,1,7,4,12,GOLEM21,927,4/13/22
8418,2,7,0,9,GOLEM22,930,4/13/22
8419,1,6,1,8,SHINR81,939,4/13/22
8420,1,6,1,8,SHINR82,942,4/13/22
8421,3,1,0,4,AMMO02,951,4/13/22
8422,1,1,2,4,HANG51,948,4/13/22
8423,1,1,1,3,HANG52,954,4/13/22
8424,0,0,1,1,BADGR01,924,4/13/22
8425,1,5,1,7,BALL52,945,4/13/22
8426,1,2,1,4,BADGR04,1000,4/13/22
8427,1,2,1,4,BADGR05,957,4/13/22
8428,3,1,2,6,PHNTM69,1006,4/13/22
8429,1,1,1,3,BADGR08,1003,4/13/22
8430,1,1,1,3,BADGR03,1009,4/13/22
8431,1,1,1,3,PHNTM77,1012,4/13/22
8432,3,2,0,5,SMALL36,1018,4/13/22
8433,0,2,1,3,DRAGN47,1015,4/13/22
8434,1,7,1,9,AXLE11,1021,4/13/22
8435,1,7,1,9,AXLE12,1024,4/13/22
8436,1,6,2,9,LOOT45,1033,4/13/22
8437,1,2,1,4,COACH21,1027,4/13/22
8438,2,2,2,6,COACH22,1033,4/13/22
8439,1,6,1,8,CREEP31,1100,4/13/22
8440,1,6,3,10,CREEP32,1103,4/13/22
8441,1,6,0,7,TORA21,1106,4/13/22
8442,1,6,0,7,TORA22,1109,4/13/22
8443,4,2,0,6,POST61,1136,4/13/22
8444,1,2,0,3,POST62,1139,4/13/22
8445,2,5,0,7,BALL69,1121,4/13/22
8446,4,3,0,7,RENO71,1130,4/13/22
8447,3,4,1,8,SMALL65,1127,4/13/22
8448,4,2,0,6,LOST81,1115,4/13/22
8449,4,2,1,7,LOST82,1115,4/13/22
8450,4,4,1,9,etch41,1155,4/13/22
8451,1,4,0,5,etch42,1145,4/13/22
8452,3,1,2,6,SMALL72,1142,4/13/22
8453,4,3,0,7,RENO72,1133,4/13/22
8454,3,3,1,7,SMALL06,1206,4/13/22
8455,3,1,3,7,small75,1151,4/13/22
8456,1,1,1,3,DRAGN39,1200,4/13/22
8457,0,6,7,13,DRAGN66,1154,4/13/22
8458,0,8,6,14,BALL44,1112,4/13/22
8459,4,4,2,10,SMALL77,1157,4/13/22
8460,1,4,5,10,DRAGN38,1209,4/13/22
8461,0,3,0,3,DRAGN33,1218,4/13/22
8462,1,4,3,8,SCARE12,1203,4/13/22
8463,2,3,4,9,DRAGN37,1215,4/13/22
8464,3,3,5,11,DRAGN32,1221,4/13/22
8465,1,1,4,6,DRAGN22,1224,4/13/22
8466,0,3,2,5,DRAGN24,1227,4/13/22
8467,0,3,1,4,DRAGN83,1230,4/13/22
8468,0,3,0,3,PHNTM14,1233,4/13/22
8469,1,5,1,7,STAB11,1236,4/13/22
8470,4,5,0,9,STAB12,1239,4/13/22
8471,1,4,2,7,FILL31,1251,4/13/22
8472,4,4,2,10,FILL32,1254,4/13/22
8473,2,3,0,5,DRAGN91,1248,4/13/22
8474,1,5,3,9,SHINR81,1257,4/13/22
8475,1,5,2,8,SHINR82,1300,4/13/22
8476,0,4,5,9,DRAGN65,1303,4/13/22
8477,1,2,1,4,BALL91,1242,4/13/22
8478,1,2,1,4,BALL92,1245,4/13/22
8479,1,6,3,10,COACH21,1309,4/13/22
8480,1,6,2,9,COACH22,1312,4/13/22
8481,2,2,2,6,HANG51,1315,4/13/22
8482,2,2,4,8,HANG52,1318,4/13/22
8483,1,1,4,6,VEGA21,1306,4/13/22
8484,1,1,7,9,VEGA22,1321,4/13/22
8485,3,1,0,4,SMALL55,1403,4/13/22
8486,3,1,0,4,SMALL54,1400,4/13/22
8487,3,1,0,4,SMALL65,1427,4/13/22
8488,2,4,1,7,AMMO05,1424,4/13/22
8489,1,2,2,5,BADGR04,1445,4/13/22
8490,2,3,4,9,BALL18,1430,4/13/22
8491,2,5,1,8,RECON71,1433,4/13/22
8492,1,2,1,4,EASY81,1435,4/13/22
8493,1,2,1,4,RECON09,1442,4/13/22
8494,1,2,1,4,CREEP31,1506,4/13/22
8495,4,2,2,8,CREEP32,1509,4/13/22
8496,0,0,0,0,ETCH41,0,4/13/22
8497,1,1,2,4,BADGR08,1454,4/13/22
8498,1,1,3,5,BADGR03,1448,4/13/22
8499,1,4,2,7,ETCH41,1436,4/13/22
8500,4,4,0,8,ETCH42,1439,4/13/22
8501,4,2,0,6,RENO71,1500,4/13/22
8502,1,2,0,3,RENO71,1521,4/13/22
8503,0,0,0,0,FURY04,0,4/13/22
8504,1,1,2,4,FURY04,1642,4/13/22
8505,3,1,1,5,SMALL05,1648,4/13/22
8506,2,1,1,4,HYDRA91,1657,4/13/22
8507,2,1,1,4,HYDRA92,1657,4/13/22
8508,3,4,2,9,SMALL11,1700,4/13/22
8509,4,6,0,10,SMALL 15,1527,4/13/22
8510,2,2,1,5,TAUNT41,1530,4/13/22
8511,2,2,2,6,TAUNT42,1533,4/13/22
8512,0,0,5,5,DRAGN77,806,4/14/22
8513,1,2,7,10,DRAGN75,954,4/14/22
8514,2,0,4,6,DRAGN37,824,4/14/22
8515,2,0,6,8,DRAGN38,833,4/14/22
8516,0,1,0,1,DRAGN44,812,4/14/22
8517,0,1,6,7,HOOK66,815,4/14/22
8518,1,1,2,4,SCARE12,818,4/14/22
8519,2,1,4,7,DRAGN39,827,4/14/22
8520,0,1,1,2,RHINO99,800,4/14/22
8521,1,1,2,4,EASY31,816,4/14/22
8522,2,1,1,4,DRAGN91,830,4/14/22
8523,1,1,0,2,DRAGN17,836,4/14/22
8524,1,2,3,6,SCARE99,842,4/14/22
8525,3,1,0,4,SMALL75,851,4/14/22
8526,0,0,4,4,DRAGN22,845,4/14/22
8527,1,2,5,8,DRAGN19,903,4/14/22
8528,1,0,1,2,RECON81,859,4/14/22
8529,0,0,0,0,HOOK33,839,4/14/22
8530,1,2,2,5,DRAGN83,903,4/14/22
8531,1,1,0,2,BALL88,857,4/14/22
8532,1,2,0,3,PAWS30,910,4/14/22
8533,1,2,0,3,PAWS31,912,4/14/22
8534,1,1,3,5,CRAZE25,927,4/14/22
8536,1,0,5,6,BALL77,906,4/14/22
8537,1,2,3,6,HANG51,942,4/14/22
8538,1,2,1,4,HANG52,945,4/14/22
8539,1,1,0,2,PAWS16,930,4/14/22
8540,1,1,2,4,PAWS17,933,4/14/22
8541,1,2,0,3,POST61,948,4/14/22
8542,1,2,2,5,POST62,951,4/14/22
8543,1,1,,,PAWS70,921,4/14/22
8544,1,1,,,PAWS71,924,4/14/22
8545,2,3,2,7,PAWS13,936,4/14/22
8546,2,3,0,5,PAWS15,939,4/14/22
8547,1,1,1,3,CREEP31,954,4/14/22
8548,1,1,2,4,CREEP32,957,4/14/22
8549,1,1,0,2,PAWS50,915,4/14/22
8550,1,1,0,2,PAWS51,924,4/14/22
8551,1,1,0,2,SHINR81,1000,4/14/22
8552,4,1,0,5,SHINR82,1003,4/14/22
8553,1,2,1,4,COACH21,1006,4/14/22
8554,4,2,0,6,COACH22,1009,4/14/22
8555,1,1,1,3,BADGR09,1018,4/14/22
8556,1,0,0,1,BADGR01,1021,4/14/22
8557,1,1,0,2,BADGR05,1027,4/14/22
8558,1,3,0,4,FURY04,1024,4/14/22
8559,2,0,1,3,DRAGN31,1036,4/14/22
8560,1,2,1,4,BADGR04,1033,4/14/22
8561,0,2,4,6,DRAGN03,1054,4/14/22
8562,1,4,0,5,STAB11,1012,4/14/22
8563,1,4,3,8,STAB12,1015,4/14/22
8564,4,1,0,5,PHNTM69,1030,4/14/22
8565,0,2,4,6,HOOK68,1045,4/14/22
8566,2,2,2,6,SLOW51,1042,4/14/22
8567,1,2,1,4,SLOW52,1045,4/14/22
8568,1,3,1,5,TORA11,1048,4/14/22
8569,1,3,0,4,TORA12,1051,4/14/22
8570,2,4,2,8,TAUNT11,1118,4/14/22
8571,2,4,0,6,TAUNT12,1121,4/14/22
8572,2,2,3,7,GOLEM41,1109,4/14/22
8573,2,2,2,6,GOLEM42,1112,4/14/22
8574,1,3,1,5,OUZO31,1103,4/14/22
8575,1,3,1,5,OUZO32,1106,4/14/22
8576,2,3,2,7,BALL14,1115,4/14/22
8577,1,3,0,4,WIRE31,1133,4/14/22
8578,3,3,0,6,WIRE31,1136,4/14/22
8579,1,0,1,2,COBRA04,1130,4/14/22
8580,0,5,5,10,DRAGN75,1142,4/14/22
8581,3,0,2,5,SMALL77,1157,4/14/22
8582,3,2,0,5,SMALL73,1145,4/14/22
8583,4,3,2,9,SMALL75,1151,4/14/22
8584,0,4,3,7,DRAGN86,1154,4/14/22
8585,0,3,5,8,DRAGN65,1157,4/14/22
8586,0,4,7,11,DRAGN66,1200,4/14/22
8587,1,0,5,6,SCARE83,1203,4/14/22
8588,3,0,1,4,SMALL22,1242,4/14/22
8589,0,3,7,10,DRAGN37,1248,4/14/22
8590,1,2,3,6,BADGR03,1600,4/14/22
8591,3,1,5,9,RENO71,1251,4/14/22
8592,1,1,3,5,RENO71,1251,4/14/22
8593,1,1,2,4,BALL03,1300,4/14/22
8594,0,2,1,3,DRAGN99,1303,4/14/22
8595,1,4,1,6,SCARE59,1306,4/14/22
8596,0,0,2,2,DRAGN24,1312,4/14/22
8597,0,4,0,4,RECON69,1257,4/14/22
8598,0,1,1,2,DRAGN33,1309,4/14/22
8599,0,2,3,5,DRAGN21,1315,4/14/22
8600,0,1,3,4,DRAGN22,1318,4/14/22
8601,2,4,1,7,ETCH41,1321,4/14/22
8602,1,4,6,11,ETCH42,1324,4/14/22
8603,1,3,2,6,POST61,1327,4/14/22
8604,4,3,0,7,POST62,1327,4/14/22
8605,1,3,3,7,CREEP31,1333,4/14/22
8606,4,3,1,8,CREEP32,1333,4/14/22
8607,0,0,4,4,MANLY33,1424,4/14/22
8608,3,2,0,5,SMALL64,1424,4/14/22
8609,2,0,1,3,DRAGN44,1433,4/14/22
8610,1,2,1,4,HANG51,1436,4/14/22
8611,1,2,2,5,HANG52,1439,4/14/22
8612,1,1,1,3,SHINR81,1442,4/14/22
8613,1,1,2,4,SHINR82,1442,4/14/22
8614,1,3,6,10,AMMO08,1451,4/14/22
8615,0,4,1,5,LOOT06,1457,4/14/22
8616,1,0,2,3,EASY31,1505,4/14/22
8617,3,1,1,5,SMALL05,1503,4/14/22
8618,3,2,1,6,AMMO05,1500,4/14/22
8619,3,1,4,8,RECON01,0,4/14/22
8620,1,2,3,6,BADGR04,0,4/14/22
8621,3,2,2,7,BADGR09,0,4/14/22
8622,1,1,2,4,PHNTM69,0,4/14/22
8623,1,1,2,4,BADGR05,0,4/14/22
8624,1,1,3,5,BADGR77,0,4/14/22
8625,0,4,3,7,BALL38,0,4/14/22
8626,2,1,2,5,COACH21,0,4/14/22
8627,2,1,2,5,COACH22,0,4/14/22
8628,2,4,5,11,TORA31,0,4/14/22
8629,0,1,3,4,BALL82,0,4/14/22
8630,1,1,6,8,DRAGN37,0,4/14/22
8631,2,4,2,8,TORA32,0,4/14/22
8632,2,1,1,4,GIZMO52,0,4/14/22
8633,1,1,1,3,GOLEM11,0,4/14/22
8634,2,1,1,4,GOLEM12,0,4/14/22
8635,4,1,1,6,FILL31,0,4/14/22
8636,4,1,3,8,FILL32,0,4/14/22
8637,0,2,3,5,GIZMO51,0,4/14/22
8639,0,3,1,4,DRAGN77,800,4/15/22
8640,0,4,5,9,dragon03,803,4/15/22
8641,4,4,1,9,dragn06,806,4/15/22
8642,2,0,2,4,CRAZY48,809,4/15/22
8643,1,5,4,10,SHINR82,815,4/15/22
8644,1,5,5,11,VEGA21,824,4/15/22
8645,0,2,6,8,DRAGN66,812,4/15/22
8646,1,2,2,5,SCARE19,842,4/15/22
8647,0,4,6,10,DRAGN21,838,4/15/22
8648,0,1,1,2,CRAZE86,830,4/15/22
8649,1,2,4,7,DRAGN37,821,4/15/22
8650,0,4,1,5,DRAGN33,839,4/15/22
8651,0,4,5,9,DRAGN22,836,4/15/22
8652,1,4,3,8,SCARE36,906,4/15/22
8653,0,4,2,6,PHNTM14,845,4/15/22
8654,0,1,0,1,CRAZE11,848,4/15/22
8655,3,3,3,9,TORA11,851,4/15/22
8656,4,1,2,7,SMALL05,903,4/15/22
8657,0,4,5,9,DRAGN62,912,4/15/22
8658,0,5,6,11,DRAGN75,909,4/15/22
8659,2,6,1,9,ETCH41,915,4/15/22
8660,3,5,0,8,SMALL13,921,4/15/22
8661,2,2,2,6,HOOK91,900,4/15/22
8662,3,4,0,7,SCARE59,930,4/15/22
8663,2,5,2,9,DRAGN81,924,4/15/22
8664,2,5,3,10,DRAGN53,927,4/15/22
8665,5,1,1,7,RENO71,932,4/15/22
8666,0,4,1,5,GHOST53,954,4/15/22
8667,2,5,1,8,RECON03,945,4/15/22
8668,1,5,3,9,WIRE31,939,4/15/22
8669,1,3,1,5,HOOK99,857,4/15/22
8670,1,5,1,7,BALL56,951,4/15/22
8671,1,5,3,9,BALL14,948,4/15/22
8672,1,5,3,9,SCARE72,957,4/15/22
8673,3,5,1,9,BADGR09,1000,4/15/22
8674,1,4,2,7,RECON08,1003,4/15/22
8675,0,6,2,8,CRAZE25,1009,4/15/22
8676,0,3,0,3,PHNTM77,1006,4/15/22
8677,1,1,0,2,GIZMO11,1012,4/15/22
8678,2,4,0,6,SLOW61,1100,4/15/22
8679,4,2,0,6,SLOW62,1104,4/15/22
8680,0,5,3,8,SPECK02,1103,4/15/22
8681,2,5,1,8,AMMO09,1115,4/15/22
8682,0,4,3,7,BALL32,1112,4/15/22
8683,0,4,1,5,BADGR04,1124,4/15/22
8684,1,6,4,11,BALL38,1109,4/15/22
8685,2,6,6,14,DRAGN21,1236,4/15/22
8686,1,4,3,8,DRAGN75,1209,4/15/22
8687,0,2,0,2,DRAGN44,1233,4/15/22
8688,1,5,2,8,DAWG01,1300,4/15/22
8689,1,4,0,5,TORA81,1306,4/15/22
8690,2,1,2,5,TORA82,1309,4/15/22
8691,2,3,0,5,RAGTAG1,1415,4/15/22
8692,2,3,2,7,RAGTAG2,1418,4/15/22
8693,2,3,0,5,RAGTAG3,1421,4/15/22
8694,2,3,4,9,RAGTAG4,1424,4/15/22
8695,4,5,4,13,SCARE18,1427,4/15/22
8696,4,5,3,12,ETCH41,1433,4/15/22
8697,1,5,1,7,ETCH42,0,4/15/22
8698,1,1,1,3,EASY81,1435,4/15/22
8699,0,5,2,7,DAWG02,1430,4/15/22
8700,0,4,3,7,BALL89,1439,4/15/22
8701,1,5,7,13,SPECK69,1448,4/15/22
8702,1,3,2,6,STAB11,1451,4/15/22
8703,1,3,5,9,STAB22,1454,4/15/22
8704,1,4,2,7,WIRE31,1503,4/15/22
8705,1,4,3,8,WIRE32,1506,4/15/22
8706,1,1,1,3,SHINR81,1509,4/15/22
8707,1,1,2,4,SHINR82,1512,4/15/22
8708,3,4,1,8,BADGR05,1536,4/15/22
8709,1,5,2,8,AMM09,1515,4/15/22
8710,0,2,5,7,AMMO08,1518,4/15/22
8711,2,1,0,3,OUZO11,1524,4/15/22
8712,2,1,1,4,OUZO12,1527,4/15/22
8713,0,4,1,5,RECON71,1521,4/15/22
8714,0,6,1,7,BALL31,1542,4/15/22
8715,1,5,4,10,DRAGN38,1545,4/15/22
8716,1,5,3,9,DRAGN37,1548,4/15/22
8717,0,6,3,9,DRAGN06,1551,4/15/22
8718,1,0,3,4,DRAGN31,906,4/18/22
8719,1,2,2,5,DRAGN32,903,4/18/22
8720,2,2,2,6,DRAGN36,903,4/18/22
8721,1,5,1,7,HANG51,921,4/18/22
8722,2,3,1,6,DRAGN53,918,4/18/22
8723,0,6,4,10,HOOK66,927,4/18/22
8724,1,7,2,10,SCARE26,933,4/18/22
8725,0,0,1,1,RHINO99,900,4/18/22
8726,1,3,3,7,HOOK69,936,4/18/22
8727,3,1,3,7,DRAGN38,915,4/18/22
8728,1,4,1,6,CRAZE54,957,4/18/22
8729,0,3,0,3,PAWS16,945,4/18/22
8730,1,2,0,3,DRAGN02,1006,4/18/22
8731,1,3,0,4,BADGR03,948,4/18/22
8732,1,1,0,2,DRAGN03,1003,4/18/22
8733,1,0,0,1,BALL79,1000,4/18/22
8734,1,6,1,8,SCARE76,1009,4/18/22
8735,0,4,1,5,AMMO02,1015,4/18/22
8736,0,2,0,2,BADGER09,948,4/18/22
8737,1,3,1,5,BALL19,1012,4/18/22
8738,1,4,2,7,GULEM21/22,1048,4/18/22
8739,2,1,4,7,CRAZE34,1042,4/18/22
8740,2,2,1,5,SLOW11,1054,4/18/22
8741,3,1,1,5,SMALL45,1039,4/18/22
8742,1,3,0,4,AMMO05,1045,4/18/22
8743,1,6,1,8,GIZMO21,0,4/18/22
8744,0,4,0,4,GOLEM11,1133,4/18/22
8745,0,3,1,4,GIZMO52,1133,4/18/22
8746,1,4,2,7,FILL31,1300,4/18/22
8747,2,0,1,3,FILL11,1239,4/18/22
8748,0,3,2,5,DRAGN31,1248,4/18/22
8749,2,3,5,10,DRAGN32,1245,4/18/22
8750,3,2,0,5,SMALL26,1254,4/18/22
8751,1,3,2,6,EASY85,1232,4/18/22
8752,1,5,4,10,ETCH41,1257,4/18/22
8753,2,4,4,10,HOOK66,1306,4/18/22
8754,0,5,1,6,DRAGN62,1309,4/18/22
8755,2,3,0,5,PAWS55,1303,4/18/22
8756,4,0,1,5,SMALL35,1251,4/18/22
8757,1,2,3,6,HYDRA11,1318,4/18/22
8758,1,6,4,11,SCARE26,1324,4/18/22
8759,0,6,1,7,DRAGN71,1327,4/18/22
8760,0,4,4,8,HOOK03,1054,4/18/22
8761,1,3,4,8,VEGA21,1342,4/18/22
8762,1,3,1,5,VEGA22,1345,4/18/22
8763,1,3,2,6,REZON82,1354,4/18/22
8764,2,2,1,5,CREEP31,1348,4/18/22
8765,2,2,1,5,CREEP32,1348,4/18/22
8766,3,5,0,8,SCARE71,1400,4/18/22
8767,4,3,1,8,SMALL56,1406,4/18/22
8768,0,1,0,1,BALL88,1357,4/18/22
8769,0,3,4,7,AMMO08,1403,4/18/22
8770,0,5,1,6,CRAZE76,1409,4/18/22
8771,2,4,4,10,CRAZE34,1442,4/18/22
8772,2,3,1,6,EPIC99,1400,4/18/22
8773,2,5,1,8,TORA31,1533,4/18/22
8774,2,5,1,8,TORA32,1536,4/18/22
8775,4,4,1,9,DRAGN61,1545,4/18/22
8776,0,1,2,3,AMMO02,1557,4/18/22
8777,1,3,0,4,AXLE11,1603,4/18/22
8778,4,3,1,8,AXLE12,1603,4/18/22
8779,3,4,1,8,HOOK65,1548,4/18/22
8780,1,4,1,6,LOOT50,1600,4/18/22
8781,0,2,5,7,DRAGN22,1609,4/18/22
8782,0,1,2,3,DRAGN83,1612,4/18/22
8783,2,4,3,9,DRAGN99,1618,4/18/22
8784,0,3,0,3,PHNTM14,1545,4/18/22
8785,0,2,0,2,DRAGN33,1621,4/18/22
8786,0,2,2,4,DRAGN23,1624,4/18/22
8787,0,3,2,5,DRAGN21,1612,4/18/22
8788,2,4,1,7,DRAGN48,1633,4/18/22
8789,2,2,1,5,DRAGN06,1630,4/18/22
8790,0,4,3,7,GIZMO07,1630,4/18/22
8791,0,4,3,7,BALL56,1554,4/18/22
8792,1,5,1,7,COACH21,1642,4/18/22
8793,1,5,2,8,COACH22,1645,4/18/22
8794,1,0,0,1,SHINR81,1648,4/18/22
8795,1,0,0,1,SHINR82,1648,4/18/22
8796,1,4,1,6,BALL63,1654,4/18/22
8797,0,5,1,6,BALL58,1657,4/18/22
8798,3,3,1,7,SMALL56,1706,4/18/22
8799,3,3,1,7,SMALL55,1703,4/18/22
8800,0,3,3,6,SPECK69,1700,4/18/22
8801,1,3,2,6,RECON88,2009,4/18/22
8802,1,3,5,9,CRAZE76,2039,4/18/22
8803,1,2,0,3,DRAGN91,2000,4/18/22
8804,2,2,5,9,BALL32,2027,4/18/22
8805,2,2,1,5,BALL37,2024,4/18/22
8806,2,2,2,6,BALL64,2036,4/18/22
8807,1,5,5,11,DRAGN71,1957,4/18/22
8808,1,4,3,8,DRAGN61,2021,4/18/22
8809,2,2,3,7,HOOK22,2015,4/18/22
8810,2,3,2,7,BALL52,2030,4/18/22
8811,1,0,2,3,DRAGN83,2018,4/18/22
8812,2,0,1,3,GHOST53,2033,4/18/22
8813,1,2,1,4,BALL63,2042,4/18/22
8814,0,8,3,11,DRAGN66,921,4/19/22
8815,4,4,0,8,SMALL05,903,4/19/22
8816,1,7,3,11,SCARE11,924,4/19/22
8817,0,6,3,9,PAWS42,948,4/19/22
8818,2,7,1,10,CRAZE16,933,4/19/22
8819,3,7,1,11,CRAZE54,942,4/19/22
8820,1,8,2,11,0936,0,4/19/22
8821,4,5,0,9,SMALL23,945,4/19/22
8822,1,6,1,8,SMALL10,912,4/19/22
8823,3,6,0,9,SMALL07,909,4/19/22
8824,2,6,2,10,PHNTM51,951,4/19/22
8825,2,6,1,9,DRAGN53,954,4/19/22
8826,1,9,1,11,BALL89,1006,4/19/22
8827,1,7,4,12,TAUNT41,1000,4/19/22
8828,1,7,1,9,TAUNT42,1000,4/19/22
8829,2,7,4,13,DRAGN71,1021,4/19/22
8830,0,8,1,9,HOOK06,1103,4/19/22
8831,2,6,2,10,DRAGN48,1106,4/19/22
8832,2,8,4,14,SLOW51,1109,4/19/22
8833,1,8,4,13,SLOW52,1109,4/19/22
8834,2,4,2,8,SLOW11,1057,4/19/22
8835,1,4,0,5,SLOW12,1057,4/19/22
8836,1,7,1,9,SLOW61,1230,4/19/22
8837,2,7,2,11,SLOW62,1230,4/19/22
8838,1,7,0,8,GOLEM21,1236,4/19/22
8839,1,7,2,10,GOLEM22,1236,4/19/22
8840,2,2,0,4,DRAGN91,1248,4/19/22
8841,1,4,,,GOLEM21,1200,4/19/22
8842,1,6,2,9,DRAGN32,1257,4/19/22
8843,2,5,1,8,CRAZE88,1300,4/19/22
8845,0,8,6,14,HOOK66,1309,4/19/22
8846,0,6,1,7,DRAGN62,1303,4/19/22
8847,1,6,1,8,DRAGN96,1306,4/19/22
8848,1,5,1,7,SCARE13,1312,4/19/22
8849,1,6,2,9,CRAZE44,1318,4/19/22
8850,2,9,1,12,SCARE29,1315,4/19/22
8851,0,7,2,9,DRAGN72,1321,4/19/22
8852,0,5,4,9,CRAZE16,1324,4/19/22
8853,4,8,1,13,ETCH41,1348,4/19/22
8854,0,3,2,5,BALL81,1336,4/19/22
8855,4,5,0,9,HANG51,1351,4/19/22
8856,1,5,0,6,BALL02,1333,4/19/22
8857,0,5,0,5,BADGR01,1327,4/19/22
8858,0,4,0,4,BALL69,1403,4/19/22
8859,1,8,2,11,DRAGN75,1357,4/19/22
8860,0,6,2,8,AMMO09,1409,4/19/22
8861,1,5,6,12,BALL88,1400,4/19/22
8862,0,8,0,8,BALL15,1406,4/19/22
8863,0,6,2,8,RECON99,1412,4/19/22
8864,3,4,3,10,SMALL60,1412,4/19/22
8865,0,5,1,6,DRAGN65,1418,4/19/22
8866,0,6,0,6,DAWG02,1424,4/19/22
8867,3,2,6,11,SMALL27,1557,4/19/22
8868,3,6,1,10,SMALL25,1551,4/19/22
8869,0,7,0,7,HOOK61,1542,4/19/22
8870,0,3,3,6,PAWS14,1548,4/19/22
8871,1,7,2,10,WIRE31/32,1600,4/19/22
8872,0,7,1,8,DRAGN33,1615,4/19/22
8873,1,9,0,10,COACH21,1606,4/19/22
8874,1,8,3,12,DRAGN22,1612,4/19/22
8875,0,9,0,9,DRAGN99,1618,4/19/22
8876,0,8,2,10,DRAGN23,1424,4/19/22
8877,0,7,3,10,DRAGN83,1621,4/19/22
8878,1,7,0,8,LOOT45,0,4/19/22
8879,4,1,0,5,SPECK69,1636,4/19/22
8880,2,6,2,10,TORA 31/32,1657,4/19/22
8881,1,9,3,13,STAB11,1733,4/19/22
8882,3,2,0,5,LOST11,1906,4/19/22
8883,4,2,1,7,LOST12,1909,4/19/22
8884,2,2,2,6,DRAGN32,2018,4/19/22
8885,2,4,1,7,FURY01,2032,4/19/22
8886,2,2,2,6,BALL63,2000,4/19/22
8887,3,1,1,5,DRAGN33,2015,4/19/22
8888,3,4,3,10,BALL99,2011,4/19/22
8889,1,1,1,3,DRAGN42,2009,4/19/22
8890,2,3,2,7,BALL58,2015,4/19/22
8891,2,4,3,9,BALL56,2024,4/19/22
8892,2,1,3,6,HOOK22,2012,4/19/22
8893,2,3,3,8,EPIC02,2027,4/19/22
8894,1,0,1,2,PHNTM77,2021,4/19/22
8895,1,2,2,5,DRAGON31,903,4/20/22
8896,2,4,2,8,DRAGON48,927,4/20/22
8897,1,2,2,5,DRAGN06,924,4/20/22
8898,2,6,2,10,DRAGN47,930,4/20/22
8899,0,8,4,12,HOOK69,933,4/20/22
8900,2,6,0,8,DRAGN99,1009,4/20/22
8901,0,6,0,6,BALL69,1003,4/20/22
8902,0,2,1,3,BALL88,1006,4/20/22
8903,2,4,2,8,BALL12,1027,4/20/22
8904,1,2,4,7,HOOK66,1033,4/20/22
8905,2,5,0,7,PAWS76,1030,4/20/22
8906,1,4,1,6,BALL15,1036,4/20/22
8907,1,6,4,11,TAUNT41,1051,4/20/22
8908,2,6,1,9,DAWG01,1042,4/20/22
8909,3,6,2,11,SLOW61,1118,4/20/22
8910,1,3,3,7,GOLEM31,1130,4/20/22
8911,1,3,2,6,GIZMO51,1115,4/20/22
8912,1,7,3,11,GIZMO91,1124,4/20/22
8913,1,6,0,7,BALL89,1230,4/20/22
8914,2,6,1,9,TAUNT11,1233,4/20/22
8915,0,5,2,7,DRAGN72,1254,4/20/22
8916,0,4,0,4,PAWS14,1312,4/20/22
8917,2,3,1,6,CRAZE,1315,4/20/22
8918,2,3,3,8,PHANTM03,1300,4/20/22
8919,0,6,4,10,DRAGN71,1257,4/20/22
8920,2,3,2,7,DRAGN44,1321,4/20/22
8921,2,6,2,10,HANG51,1309,4/20/22
8922,2,6,5,13,HANG52,1312,4/20/22
8923,2,4,3,9,DRAGN48,1318,4/20/22
8924,0,6,1,7,HOOK62,1330,4/20/22
8925,1,6,7,14,HOOK66,1327,4/20/22
8926,0,4,0,4,PAWS15,1354,4/20/22
8927,0,4,1,5,DRAGN91,1336,4/20/22
8928,1,4,1,6,BALL91,1400,4/20/22
8929,1,4,1,6,BALL92,1403,4/20/22
8930,0,6,0,6,RECON02,1421,4/20/22
8931,1,4,0,5,BALL31,1657,4/20/22
8932,2,6,2,10,PHANTOM50,1618,4/20/22
8933,1,5,2,8,LOOT45,1621,4/20/22
8934,1,5,2,8,SCARE45,1624,4/20/22
8935,0,5,1,6,PHNTM14,1630,4/20/22
8936,4,4,1,9,SCARE18,1637,4/20/22
8937,1,5,0,6,HOOK61,1645,4/20/22
8938,4,3,3,10,CRAZE41,1648,4/20/22
8939,1,6,0,7,WIRE31,1651,4/20/22
8940,1,6,4,11,WIRE32,1654,4/20/22
8941,1,5,4,10,BALL58,1706,4/20/22
8942,1,5,2,8,COACH21,1703,4/20/22
8943,1,5,1,7,COACH22,1706,4/20/22
8944,1,4,1,6,SHINR81,1715,4/20/22
8945,1,4,1,6,SHINR82,1718,4/20/22
8946,0,5,4,9,RECON99,1751,4/20/22
8947,0,2,4,6,LOOT55,1712,4/20/22
8948,4,6,3,13,BALL52,1754,4/20/22
8949,4,6,3,13,BALL52,2054,4/20/22
8950,2,4,0,6,HOOK33,2015,4/20/22
8951,2,1,2,5,HOOK22,2012,4/20/22
8952,2,0,1,3,LOOT48,2036,4/20/22
8953,1,3,1,5,BALL14,2033,4/20/22
8954,2,2,2,6,BALL36,2030,4/20/22
8955,2,3,3,8,BALL65,2039,4/20/22
8956,2,0,2,4,BALL72,2042,4/20/22
8957,2,1,2,5,RECON87,2021,4/20/22
8958,2,0,3,5,BALL31,2027,4/20/22
8959,0,5,0,5,BALL91,918,4/21/22
8960,1,4,1,6,HOOK91,915,4/21/22
8961,0,4,1,5,DRAGN31,921,4/21/22
8962,0,8,4,12,HOOK66,927,4/21/22
8963,0,7,0,7,LOOT45,924,4/21/22
8964,1,5,1,7,PAWS42,939,4/21/22
8965,0,3,0,3,BALL12,930,4/21/22
8966,2,3,1,6,DRAGN48,954,4/21/22
8967,0,3,0,3,LOOT03,906,4/21/22
8968,0,2,0,2,PAWS15,1030,4/21/22
8969,1,3,3,7,DRAGN75,1021,4/21/22
8970,2,8,1,11,DRAGN71,1018,4/21/22
8971,0,5,1,6,GHOST53,1036,4/21/22
8972,1,5,1,7,PAWS76,1048,4/21/22
8973,0,3,2,5,LOOT55,1054,4/21/22
8974,0,3,0,3,LOOT06,1045,4/21/22
8975,2,2,0,4,HYDRA11,1112,4/21/22
8976,2,2,2,6,HYDRA12,1113,4/21/22
8977,2,2,1,5,HYDRA13,1114,4/21/22
8978,2,2,2,6,HYDRA14,1115,4/21/22
8979,1,6,1,8,LOST11,1106,4/21/22
8980,1,6,0,7,LOST12,1109,4/21/22
8981,1,3,2,6,DAWG01,1100,4/21/22
8982,1,3,0,4,GIZMO51,1309,4/21/22
8983,1,3,3,7,GIZMO52,1127,4/21/22
8984,0,6,2,8,H0OK72,1130,4/21/22
8985,2,2,1,5,cobra07,1257,4/21/22
8986,2,5,2,9,craze41,1254,4/21/22
8987,0,3,4,7,ball35,1300,4/21/22
8988,2,1,0,3,cobra04,1306,4/21/22
8989,1,8,2,11,HANG51,1336,4/21/22
8990,1,8,3,12,HANG52,1339,4/21/22
8991,0,1,3,4,DRAGN33,1324,4/21/22
8992,0,5,1,6,PHNTM14,1327,4/21/22
8993,0,3,0,3,RECON09,1330,4/21/22
8994,1,1,1,3,CRAZE88,1348,4/21/22
8995,1,6,1,8,SCARE29,1345,4/21/22
8996,2,2,3,7,DRAGN48,1351,4/21/22
8997,1,6,1,8,SCARE11,1354,4/21/22
8998,0,4,2,6,HOOK61,1357,4/21/22
8999,1,2,6,9,HOOK66,1409,4/21/22
9000,2,1,2,5,DRAGN44,1418,4/21/22
9001,1,3,2,6,CREEP31,1400,4/21/22
9002,1,3,0,4,CREEP32,1403,4/21/22
9003,0,2,0,2,CRAZE55,1406,4/21/22
9004,2,5,2,9,SLOW61,1427,4/21/22
9005,1,5,1,7,SLOW62,1430,4/21/22
9006,1,3,2,6,DRAGN42,1421,4/21/22
9007,0,1,4,5,DRAGN22,2433,4/21/22
9008,0,5,2,7,DRAGN62,1442,4/21/22
9009,1,5,2,8,RENO71,1445,4/21/22
9010,2,5,1,8,RENO72,1448,4/21/22
9011,2,2,2,6,Gizmo 31,1621,4/21/22
9012,2,2,2,6,Gizmo32,1624,4/21/22
9013,1,4,4,9,PHNTM69,1633,4/21/22
9014,3,4,2,9,BADGR05,0,4/21/22
9015,1,6,2,9,TAUNT41,1651,4/21/22
9016,1,6,0,7,TAUNT42,1654,4/21/22
9017,1,3,2,6,POST61,1642,4/21/22
9018,1,3,0,4,POST62,1645,4/21/22
9019,2,3,4,9,DAWG04,1648,4/21/22
9020,0,5,2,7,BALL65,1634,4/21/22
9021,2,3,0,5,PHNTM50,1657,4/21/22
9022,2,4,1,7,CRAZE34,1706,4/21/22
9023,2,3,2,7,COBRA07,1709,4/21/22
9024,0,5,5,10,BALL61,1700,4/21/22
9025,2,3,3,8,COBRA05,1712,4/21/22
9026,0,5,0,5,BALL02,1703,4/21/22
9027,1,5,0,6,BALL14,1718,4/21/22
9028,1,2,0,3,SHINR81,1724,4/21/22
9029,1,2,2,5,SHINR82,1727,4/21/22
9030,1,5,1,7,TORA31,1730,4/21/22
9031,1,5,2,8,TORA32,1733,4/21/22
9032,1,3,2,6,BALL52,1739,4/21/22
9033,4,4,2,10,LOOT48,1736,4/21/22
9034,1,1,4,6,DRAGN38,1742,4/21/22
9035,1,4,1,6,FILL31,1751,4/21/22
9036,1,4,1,6,FILL32,1754,4/21/22
9037,3,6,3,12,BALL51,2018,4/21/22
9038,1,3,2,6,RECON02,2027,4/21/22
9039,2,5,1,8,BALL58,2015,4/21/22
9040,2,5,3,10,SPECK69,2021,4/21/22
9041,1,3,4,8,DRAGN36,800,4/22/22
9042,1,5,1,7,EASY85,801,4/22/22
9043,1,5,4,10,PHNTM51,812,4/22/22
9044,0,2,2,4,DRAGN23,815,4/22/22
9045,0,2,5,7,PHNTM14,818,4/22/22
9046,0,3,1,4,DRAGN33,809,4/22/22
9047,3,3,1,7,SMALL55,803,4/22/22
9048,4,3,2,9,SMALL56,806,4/22/22
9049,2,2,0,4,DRAGN05,833,4/22/22
9050,1,3,4,8,DRAGN42,833,4/22/22
9051,2,4,3,9,PHNTM03,839,4/22/22
9052,1,6,3,10,HOOK62,845,4/22/22
9053,0,3,2,5,PHNTM45,842,4/22/22
9054,1,3,2,6,CRAZE44,848,4/22/22
9055,2,5,2,9,SLOW31,824,4/22/22
9056,1,3,1,5,SLOW31,821,4/22/22
9057,4,4,2,10,RENO71,854,4/22/22
9058,1,4,1,6,RENO71,857,4/22/22
9059,4,5,2,11,BADGR04,900,4/22/22
9060,2,6,3,11,RECON04,903,4/22/22
9061,0,6,2,8,CRAZE16,906,4/22/22
9062,2,4,2,8,OUZO11,909,4/22/22
9063,2,4,0,6,OUZO12,912,4/22/22
9064,1,5,3,9,DRAGN31,915,4/22/22
9065,0,5,4,9,CRAZE76,924,4/22/22
9066,1,4,4,9,GIZMO31,918,4/22/22
9067,1,4,1,6,GIZMO32,921,4/22/22
9068,1,4,1,6,AXLE11,936,4/22/22
9069,1,4,2,7,AXLE12,939,4/22/22
9070,2,4,3,9,RECON77,933,4/22/22
9071,2,0,1,3,RECON87,930,4/22/22
9072,2,1,6,9,DAWG04,942,4/22/22
9073,0,5,3,8,CRAZE41,954,4/22/22
9074,0,3,2,5,AMMO08,954,4/22/22
9075,2,3,1,6,COBRA08,948,4/22/22
9076,1,2,1,4,WIRE31,957,4/22/22
9077,1,2,4,7,WIRE32,1000,4/22/22
9078,1,2,1,4,WIRE31,957,4/22/22
9079,1,2,4,7,WIRE32,1000,4/22/22
9080,0,1,3,4,DRAGN02,1009,4/22/22
9081,1,3,1,5,TORA51,1024,4/22/22
9082,1,3,1,5,TORA52,1027,4/22/22
9083,1,2,0,3,HOOK06,1012,4/22/22
9084,3,3,3,9,POST61,1018,4/22/22
9085,3,3,2,8,POST62,1021,4/22/22
9086,1,3,2,6,HOOK75,1030,4/22/22
9087,2,4,1,7,SLOW61,1130,4/22/22
9088,1,4,0,5,SLOW62,1133,4/22/22
9089,2,7,1,10,GOLEM21,1142,4/22/22
9090,1,7,0,8,GOLEM22,1145,4/22/22
9091,2,1,4,7,HOOK23,1206,4/22/22
9092,1,5,7,13,ETCH41,1154,4/22/22
9093,1,5,1,7,ETCH42,1200,4/22/22
9094,1,3,3,7,CRAZE33,1218,4/22/22
9095,0,2,3,5,PHNTM14,1212,4/22/22
9096,0,1,2,3,DRAGN99,1215,4/22/22
9097,2,3,4,9,RECON82,1203,4/22/22
9098,1,0,2,3,CRAZE88,1227,4/22/22
9099,1,5,3,9,SCARE29,1230,4/22/22
9100,1,5,1,7,EASY85,1220,4/22/22
9101,1,5,1,7,EASY86,1219,4/22/22
9102,3,3,3,9,BARGR03,1236,4/22/22
9103,1,5,3,9,BADGR09,1242,4/22/22
9104,1,5,4,10,BADGR04,1245,4/22/22
9105,0,2,0,2,PAWS69,1327,4/22/22
9106,0,5,1,6,HOOK03,1545,4/22/22
9107,2,1,4,7,HOOK71,1545,4/22/22
9108,2,3,0,5,BALL11,1548,4/22/22
9109,0,2,1,3,LOOT77,1539,4/22/22
9110,0,3,0,3,BALL19,1542,4/22/22
9111,1,5,1,7,BALL15,1545,4/22/22
9112,1,5,1,7,FILL31,1557,4/22/22
9113,2,3,1,6,GIZMO51,1551,4/22/22
9114,1,3,0,4,HOOK66,1536,4/22/22
9115,2,2,2,6,HOOK68,1530,4/22/22
9116,1,1,0,2,HOOK61,1630,4/22/22
9117,0,4,1,5,HOOK65,1630,4/22/22
9118,,0,0,,Taunt 11,1230,4/24/22
9119,2,3,0,5,Taunt 11,1230,4/25/22
9120,6,12,8,26,Golem11/12,1206,4/24/22
9121,2,8,1,11,Hang 51,1218,4/24/22
9122,6,2,2,10,Tora 21,1215,4/24/22
9123,1,3,2,6,Taunt 11,1232,4/24/22
9124,1,3,1,5,Golem 11,1206,4/24/22
9125,2,3,2,7,Golem 12,1209,4/24/22
9126,0,3,5,8,CRAZE 76,806,4/25/22
9127,1,7,3,11,Ball 61,809,4/25/22
9128,1,1,7,9,PHNTM 77,812,4/25/22
9129,1,2,0,3,Easy 81,856,4/25/22
9130,0,0,3,3,BADGR 04,827,4/25/22
9131,0,1,3,4,BADGR 02,821,4/25/22
9132,0,2,2,4,RHINO 99,800,4/25/22
9133,0,3,2,5,CRAZE 16,824,4/25/22
9134,2,3,4,9,SPOT 91,815,4/25/22
9135,2,3,1,6,SPOT 92,818,4/25/22
9136,0,1,1,2,DRAGN 33,848,4/25/22
9137,2,1,3,6,COBRA 06,833,4/25/22
9138,2,1,4,7,CRAZE 46,830,4/25/22
9139,1,2,0,3,RECON 81,900,4/25/22
9140,2,3,2,7,COBRA 01,836,4/25/22
9141,0,4,3,7,GHOST 53,845,4/25/22
9142,2,3,4,9,WIRE 31,842,4/25/22
9143,2,3,4,9,WIRE 32,845,4/25/22
9144,1,3,4,8,VEGA 21,851,4/25/22
9145,1,3,4,8,VEGA 22,854,4/25/22
9146,1,2,1,4,CRAZE 54,857,4/25/22
9147,1,2,5,8,DRAGN 03,903,4/25/22
9148,2,0,2,4,CRAZE 34,839,4/25/22
9149,1,2,1,4,DRAGN 99,906,4/25/22
9150,2,1,1,4,DRAGN 44,918,4/25/22
9151,0,1,4,5,DRAGN 37,930,4/25/22
9152,3,2,1,6,SMALL 15,927,4/25/22
9153,0,1,0,1,RECON 03,842,4/25/22
9154,1,3,2,6,LOST 81,921,4/25/22
9155,1,3,2,6,LOST,924,4/25/22
9156,1,2,5,8,SCARE 18,918,4/25/22
9157,1,1,3,5,DRAGN 31,933,4/25/22
9158,0,0,3,3,DRAGN 38,942,4/25/22
9159,1,1,2,4,SCARE 36,951,4/25/22
9160,4,2,1,7,BALL 79,945,4/25/22
9161,0,1,3,4,DRAGN 23,954,4/25/22
9162,0,1,1,2,PHNTM 14,957,4/25/22
9163,0,3,1,4,PAWS 42,1006,4/25/22
9164,0,1,2,3,DRAGN 62,1003,4/25/22
9165,2,2,2,6,DRAGN 53,1000,4/25/22
9166,0,2,1,3,BALL 89,1009,4/25/22
9167,1,3,2,6,TORA 21,1024,4/25/22
9168,1,2,1,4,TORA 22,1027,4/25/22
9169,2,2,1,5,CRAZE 88,1021,4/25/22
9170,0,1,0,1,BALL 88,1018,4/25/22
9171,2,1,3,6,BALL 35,1015,4/25/22
9172,4,3,1,8,GOLEM 31,1030,4/25/22
9173,4,3,1,8,GOLEM 32,1033,4/25/22
9174,0,3,4,7,LOOT 50,1012,4/25/22
9175,2,3,3,8,Dragn48,1106,4/25/22
9176,1,3,1,5,HOOK97,1115,4/25/22
9177,0,1,2,3,DRAGN77,1127,4/25/22
9178,0,5,3,8,SPECK02,1133,4/25/22
9179,2,2,1,5,SMALL72,1142,4/25/22
9180,0,2,3,5,DRAGN65,1124,4/25/22
9181,2,3,4,9,DRAGN47,1136,4/25/22
9182,1,3,4,8,PAWS66,1121,4/25/22
9183,0,3,3,6,DRAGN02,1200,4/25/22
9184,1,3,3,7,DRAGN55,1139,4/25/22
9185,2,3,2,7,DRAGN52,1145,4/25/22
9186,1,3,3,7,PAWS69,1130,4/25/22
9187,1,5,0,6,SCARE29,1154,4/25/22
9188,0,0,2,2,DRAGN61,1148,4/25/22
9189,1,5,2,8,AMMO01,1206,4/25/22
9190,2,3,2,7,AMMO09,1209,4/25/22
9191,1,4,6,11,DRAGN71,1157,4/25/22
9192,0,4,4,8,AMMO02,1218,4/25/22
9193,2,1,5,8,CRAZE46,1239,4/25/22
9194,0,5,4,9,BALL18,1212,4/25/22
9195,0,5,4,9,CRAZE76,1215,4/25/22
9196,1,1,3,5,BADGR02,1227,4/25/22
9197,1,4,8,13,BADGR09,1224,4/25/22
9198,2,2,2,6,CRAZE16,1239,4/25/22
9199,4,1,2,7,SMALL15,1227,4/25/22
9200,2,3,4,9,COBRA01,1248,4/25/22
9201,2,1,6,9,COBRA02,1242,4/25/22
9202,1,1,1,3,VEGA21,1230,4/25/22
9203,4,5,3,12,RENO71,1251,4/25/22
9204,1,0,4,5,BALL88,1300,4/25/22
9205,2,1,2,5,CRAZE34,1245,4/25/22
9206,3,3,4,10,TORA51,1300,4/25/22
9207,2,2,3,7,DRAGN91,1306,4/25/22
9208,2,2,2,6,BALL69,1303,4/25/22
9209,0,2,3,5,EPIC06,1257,4/25/22
9210,2,3,5,10,DAWG04,1406,4/25/22
9211,0,1,4,5,BALL76,1418,4/25/22
9212,4,5,0,9,DAWG02,1406,4/25/22
9213,3,1,0,4,SMALL72,1442,4/25/22
9214,1,1,4,6,SHINR81,1439,4/25/22
9215,1,4,5,10,DRAGN31,1457,4/25/22
9216,0,3,4,7,BALL14,1448,4/25/22
9217,0,2,4,6,CRAZE14,1445,4/25/22
9218,4,3,0,7,SMALL04,1500,4/25/22
9219,1,2,4,7,DRAGN37,1500,4/25/22
9220,0,3,5,8,CRAZE88,1533,4/25/22
9221,1,2,3,6,HOOK14,1506,4/25/22
9222,1,1,2,4,STAB11,1524,4/25/22
9223,1,1,1,3,STAB12,1527,4/25/22
9224,2,3,5,10,DRAGN53,1515,4/25/22
9225,2,5,3,10,DRAGN71,1518,4/25/22
9226,1,5,1,7,HANG51,1521,4/25/22
9227,1,5,3,9,HANG51,1524,4/25/22
9228,1,3,4,8,DRAGN48,1530,4/25/22
9229,0,2,2,4,HOOK68,1539,4/25/22
9230,4,1,2,7,DRAGN22,1500,4/25/22
9231,0,5,1,6,PHNTM45,1542,4/25/22
9232,2,3,3,8,AXEL11,1545,4/25/22
9233,2,3,5,10,AXEL12,1548,4/25/22
9234,4,3,2,9,SMALL24,1548,4/25/22
9235,0,7,4,11,DRAGN03,1554,4/25/22
9236,0,5,0,5,DRAGN72,1554,4/25/22
9237,1,5,1,7,RECON87,1548,4/25/22
9238,0,2,5,7,ammo08,803,4/26/22
9239,0,0,3,3,CRAZE76,806,4/26/22
9240,0,0,4,4,AMMO05,800,4/26/22
9241,0,0,4,4,AMMO01,809,4/26/22
9242,0,0,3,3,BADR02,815,4/26/22
9243,1,2,2,5,LOOT69,812,4/26/22
9244,4,0,2,6,SMALL63,821,4/26/22
9245,2,0,2,4,BADGR03,824,4/26/22
9246,4,0,1,5,SMALL62,818,4/26/22
9247,4,0,3,7,VEGA21,827,4/26/22
9248,3,2,2,7,BALL31,836,4/26/22
9249,4,3,2,9,CREEP31,839,4/26/22
9250,2,1,2,5,CRAZE34,833,4/26/22
9251,1,0,2,3,AXLE11,906,4/26/22
9252,1,0,4,5,HYDRA91,915,4/26/22
9253,4,2,3,9,STAB11,854,4/26/22
9254,1,2,0,3,SHINR81,900,4/26/22
9255,5,0,5,10,BALL44,857,4/26/22
9256,3,2,1,6,SMALL12,918,4/26/22
9257,0,0,3,3,DRAGN37,936,4/26/22
9258,4,0,1,5,SMALL91,933,4/26/22
9259,1,0,2,3,RENO71,927,4/26/22
9260,2,0,2,4,HANG51,927,4/26/22
9261,0,2,3,5,DRAGN38,939,4/26/22
9262,4,0,1,5,SMALL22,942,4/26/22
9263,0,0,3,3,DRAGN22,945,4/26/22
9264,0,0,1,1,PHANTOM14,948,4/26/22
9265,1,2,0,3,EASY86,951,4/26/22
9266,0,2,2,4,DRAGN23,1000,4/26/22
9267,3,1,0,4,SMALL31,1003,4/26/22
9268,3,2,0,5,BALL89,1004,4/26/22
9269,3,2,4,9,ETCH41,1012,4/26/22
9270,1,2,4,7,SLOW71,1018,4/26/22
9271,1,3,1,5,TORA21,1024,4/26/22
9273,1,2,2,5,Wire31,1030,4/26/22
9274,1,2,2,5,Wire32,1030,4/26/22
9275,2,2,1,5,SLOW11,1100,4/26/22
9276,1,1,1,3,PAWS88,1106,4/26/22
9277,1,2,0,3,HOOK68,1121,4/26/22
9278,1,2,2,5,FILL31,1112,4/26/22
9279,1,2,2,5,HOOK12,1115,4/26/22
9280,0,2,0,2,HOOK62,1118,4/26/22
9281,2,2,0,4,DRAGN51,1130,4/26/22
9282,1,2,0,3,HOOK44,1130,4/26/22
9283,3,2,1,6,SMALL67,1133,4/26/22
9284,4,1,4,9,STAB11,1136,4/26/22
9285,1,1,1,3,STAB12,1139,4/26/22
9286,2,1,1,4,SMALL72,1142,4/26/22
9287,2,2,0,4,CRAZE44,1154,4/26/22
9288,0,2,1,3,DRAGN77,1203,4/26/22
9289,0,2,4,6,HOOK61,1145,4/26/22
9290,0,2,3,5,DRAGN75,1200,4/26/22
9291,1,2,2,5,AXLE11,1151,4/26/22
9292,1,2,4,7,AXLE12,1148,4/26/22
9293,0,2,0,2,HOOK97,1157,4/26/22
9294,0,2,6,8,AMMO08,1209,4/26/22
9295,2,2,4,8,PAWS76,1212,4/26/22
9296,0,2,3,5,RECON71,1215,4/26/22
9297,2,2,3,7,BADGR04,1200,4/26/22
9298,3,1,4,8,SMALL17,1233,4/26/22
9299,2,2,5,9,BALL15,0,4/26/22
9300,2,2,5,9,BALL15,1206,4/26/22
9301,2,2,4,8,CRAZE16,1227,4/26/22
9302,2,1,2,5,LOST69,1221,4/26/22
9303,2,2,2,6,COBRA01,1239,4/26/22
9304,2,2,3,7,TORA11,1233,4/26/22
9305,0,1,2,3,BADGR02,1218,4/26/22
9306,2,2,2,6,COBRA05,1245,4/26/22
9307,2,2,0,4,COBRA08,1236,4/26/22
9308,2,2,6,10,COBRA02,1242,4/26/22
9309,2,2,5,9,COBRA01,1248,4/26/22
9310,0,3,5,8,HOOK01,1532,4/26/22
9311,2,2,2,6,RECON77,1257,4/26/22
9312,2,1,1,4,CRAZE55,1303,4/26/22
9313,1,2,2,5,BALL69,1300,4/26/22
9314,1,2,1,4,CREEP31,1312,4/26/22
9315,4,2,2,8,CREEP32,1315,4/26/22
9316,0,1,2,3,DRAGN69,1409,4/26/22
9317,1,2,5,8,TAUNT11,1433,4/26/22
9318,1,2,4,7,TAUNT12,1436,4/26/22
9319,0,2,6,8,BALL61,1439,4/26/22
9320,3,2,1,6,SMALL72,1442,4/26/22
9321,2,1,0,3,BALL79,1430,4/26/22
9322,1,2,2,5,SHINR81,1445,4/26/22
9323,4,2,2,8,SHINR82,1448,4/26/22
9324,2,2,1,5,BALL02,1454,4/26/22
9325,0,1,1,2,CRAZE14,1451,4/26/22
9326,1,2,1,4,DRAGN32,1500,4/26/22
9327,2,2,4,8,DRAGN31,1457,4/26/22
9328,4,1,1,6,SMALL07,1509,4/26/22
9329,0,2,3,5,DRAGN37,1503,4/26/22
9330,1,2,5,8,WIRE31,1518,4/26/22
9331,3,2,5,10,SMALL11,1515,4/26/22
9332,3,2,2,7,SMALL10,1512,4/26/22
9333,2,1,3,6,DRAGN22,1506,4/26/22
9334,0,2,6,8,DRAGN66,1533,4/26/22
9335,2,1,2,5,SMALL16,1530,4/26/22
9336,3,2,2,7,STABLL,1527,4/26/22
9337,1,2,3,6,STAB11,1527,4/26/22
9338,3,2,3,8,SMALL20,1530,4/26/22
9339,3,0,2,5,SMALL21,1539,4/26/22
9340,0,2,7,9,DRAGN71,1545,4/26/22
9341,4,2,0,6,DRAGN75,1542,4/26/22
9342,0,5,2,7,AMMO01,800,4/27/22
9343,2,5,3,10,PAWS76,803,4/27/22
9344,0,2,3,5,LOOT45,806,4/27/22
9345,4,3,1,8,SMALL61,815,4/27/22
9346,0,5,2,7,BALL71,812,4/27/22
9347,0,3,3,6,BADGR02,821,4/27/22
9348,4,3,2,9,SMALL62,818,4/27/22
9349,2,5,3,10,CRAZE16,824,4/27/22
9350,0,4,3,7,BADGR01,827,4/27/22
9351,2,3,2,7,FURY04,832,4/27/22
9352,0,5,2,7,CRAZE54,830,4/27/22
9353,0,1,4,5,PHNTM,836,4/27/22
9354,2,0,1,3,COBRA04,842,4/27/22
9355,1,2,1,4,COBRA08,848,4/27/22
9356,3,3,2,8,COBRA01,851,4/27/22
9357,1,3,0,4,SHINR81,903,4/27/22
9358,1,3,1,5,SHINR82,906,4/27/22
9359,2,5,6,13,DAWG01,903,4/27/22
9360,2,3,1,6,HOOK91,909,4/27/22
9361,3,3,3,9,DAWG02,854,4/27/22
9362,3,0,1,4,RECON87,900,4/27/22
9363,4,5,2,11,SMALL77,857,4/27/22
9364,1,3,5,9,DRAGN41,927,4/27/22
9365,1,5,1,7,WIRE31,921,4/27/22
9366,1,5,1,7,WIRE32,924,4/27/22
9367,0,2,4,6,DRAGN37,930,4/27/22
9368,3,1,1,5,SMALL17,933,4/27/22
9369,3,3,0,6,SMALL20,936,4/27/22
9370,0,5,3,8,DRAGN22,942,4/27/22
9371,3,1,1,5,SMALL25,951,4/27/22
9372,2,4,2,8,HOOK23,945,4/27/22
9373,2,4,2,8,PHNTM14,918,4/27/22
9374,3,5,3,11,HANG51,954,4/27/22
9375,1,5,1,7,HANG52,957,4/27/22
9376,1,5,1,7,TORA31,1006,4/27/22
9377,1,5,3,9,TORA32,1009,4/27/22
9378,1,1,3,5,DRAGN45,1018,4/27/22
9379,3,5,2,10,COACH21,1021,4/27/22
9380,1,5,0,6,COACH22,1024,4/27/22
9381,2,5,4,11,TORA41,1012,4/27/22
9382,2,5,3,10,TORA42,1015,4/27/22
9383,1,2,0,3,TAUNT11,1127,4/27/22
9384,1,2,3,6,TAUNT12,1130,4/27/22
9385,1,2,2,5,HOOK69,1133,4/27/22
9386,1,0,1,2,Gizmo51,1106,4/27/22
9387,1,0,1,2,Gizmo52,1109,4/27/22
9388,0,4,0,4,ball89,1033,4/27/22
9389,2,4,6,12,Fill31,1112,4/27/22
9390,4,4,7,15,fill32,1115,4/27/22
9391,2,4,3,9,dragn03,1127,4/27/22
9392,1,1,1,3,Golem61,1118,4/27/22
9393,1,1,1,3,Golem62,1121,4/27/22
9394,0,1,2,3,Dragn61,1130,4/27/22
9395,1,5,1,7,Reno71,1142,4/27/22
9396,1,5,3,9,Reno72,1145,4/27/22
9397,0,3,2,5,dragn32,1157,4/27/22
9398,3,5,0,8,Scare76,1148,4/27/22
9399,1,4,6,11,Dragn71,1139,4/27/22
9400,0,1,3,4,Ball11,1200,4/27/22
9401,2,3,4,9,Ammo05,1151,4/27/22
9402,1,3,5,9,BALL18,1200,4/27/22
9403,2,3,0,5,BADGR04,1209,4/27/22
9404,4,3,3,10,SMALL06,1206,4/27/22
9405,0,3,0,3,dragn72,1203,4/27/22
9406,3,3,1,7,Small13,1221,4/27/22
9407,2,3,3,8,COBRA06,1227,4/27/22
9408,1,1,1,3,WIRE31,1212,4/27/22
9409,1,1,1,3,WIRE32,1215,4/27/22
9410,0,1,1,2,BADGR02,1218,4/27/22
9411,2,3,2,7,COBRA04,1224,4/27/22
9412,2,3,3,8,COBRA01,1230,4/27/22
9413,4,0,2,6,COBRA08,1233,4/27/22
9414,2,2,1,5,PHANTOM50,1236,4/27/22
9415,2,3,1,6,RECON77,1242,4/27/22
9416,1,4,0,5,Recon81,1251,4/27/22
9417,1,4,3,8,RECON82,1254,4/27/22
9418,1,5,3,9,TAUNT41,1245,4/27/22
9419,3,5,1,9,TAUNT42,1248,4/27/22
9420,3,0,0,3,CRAZE55,1239,4/27/22
9421,0,1,1,2,DRAGN02,1257,4/27/22
9422,1,1,2,4,EASY42,1201,4/27/22
9423,16,2,0,18,DRAGN54,1300,4/27/22
9424,1,3,1,5,EASY86,1301,4/27/22
9425,1,3,0,4,SHINR81,1439,4/27/22
9426,1,3,2,6,SHINR82,1442,4/27/22
9427,2,5,1,8,BALL62,1430,4/27/22
9428,2,0,2,4,PHANTM55,1436,4/27/22
9429,4,0,4,8,SPECK69,1433,4/27/22
9430,1,3,4,8,HANG51,1445,4/27/22
9431,1,3,1,5,HANG52,1448,4/27/22
9432,0,5,4,9,DRAGN03,1427,4/27/22
9433,0,4,4,8,SPECK69,1433,4/27/22
9434,1,1,2,4,DRAGN38,1454,4/27/22
9435,0,3,6,9,HOOK37,1500,4/27/22
9436,2,2,3,7,HOOK23,1509,4/27/22
9437,0,4,2,6,PHNTM14,1512,4/27/22
9438,2,5,1,8,DRAGN91,1518,4/27/22
9439,0,5,4,9,HOOK52,1515,4/27/22
9440,2,3,4,9,STAB11,1503,4/27/22
9441,2,3,3,8,STAB12,1506,4/27/22
9442,1,2,4,7,DRAGN47,1530,4/27/22
9443,4,6,3,13,DRAGN51,1539,4/27/22
9444,2,4,1,7,TORA51,1524,4/27/22
9445,1,4,4,9,TORA51,1527,4/27/22
9446,2,3,4,9,DRAGN61,1533,4/27/22
9447,2,3,7,12,DRAGN71,1536,4/27/22
9448,0,5,4,9,DRAGN66,1542,4/27/22
9449,3,3,5,11,RECON02,1548,4/27/22
9450,0,3,0,3,DRAGN72,1545,4/27/22
9451,3,3,2,8,VEGA21,1621,4/27/22
9452,1,3,3,7,VEGA22,1624,4/27/22
9453,0,4,1,5,BALL81,903,4/28/22
9454,2,4,3,9,VEGA21,928,4/28/22
9455,2,4,0,6,VEGA22,948,4/28/22
9456,2,5,2,9,EPIC01,927,4/28/22
9457,1,2,2,5,DRAGN32,939,4/28/22
9458,1,4,4,9,SCARE26,951,4/28/22
9459,2,2,0,4,RECON03,924,4/28/22
9460,3,1,1,5,DRAGN31,950,4/28/22
9461,1,8,1,10,HANG51,954,4/28/22
9462,1,8,5,14,HANG52,957,4/28/22
9463,0,4,2,6,DRAGN37,936,4/28/22
9464,0,6,1,7,GHOST53,930,4/28/22
9465,1,7,1,9,DRAGN13,906,4/28/22
9466,2,8,1,11,DRAGN52,1000,4/28/22
9467,0,5,5,10,DRAGN66,1006,4/28/22
9468,1,5,3,9,HOOK22,1003,4/28/22
9469,2,2,2,6,DRAGN48,1009,4/28/22
9470,1,5,2,8,OUZO11,1018,4/28/22
9471,1,5,4,10,OUZO12,1021,4/28/22
9472,2,2,2,6,CRAZE88,1015,4/28/22
9473,0,4,3,7,HOOK41,1012,4/28/22
9474,1,5,1,7,GOLEM21,1030,4/28/22
9475,1,5,3,9,GOLEM22,1032,4/28/22
9476,2,3,3,8,TAUNT41,1015,4/28/22
9477,2,3,4,9,TAUNT42,1018,4/28/22
9478,2,3,2,7,SLOW11,1115,4/28/22
9479,1,3,4,8,SLOW12,1118,4/28/22
9480,1,4,1,6,GIZMO51,1109,4/28/22
9481,1,4,2,7,GIZMO52,1112,4/28/22
9482,1,4,8,13,FILL31,1121,4/28/22
9483,1,4,0,5,FILL32,1124,4/28/22
9484,1,3,0,4,RENO71,1127,4/28/22
9485,1,3,0,4,RENO72,1130,4/28/22
9486,0,3,1,4,BALL88,1200,4/28/22
9487,1,3,4,8,HOOK71,1139,4/28/22
9488,0,4,3,7,DRAGN61,1136,4/28/22
9489,1,1,5,7,PHNTM,1133,4/28/22
9490,2,1,0,3,PAWS01,1145,4/28/22
9491,0,4,3,7,DRAGN03,1151,4/28/22
9492,0,3,0,3,PAWS66,1142,4/28/22
9493,0,4,3,7,PAWS33,1154,4/28/22
9494,0,4,2,6,HOOK97,1157,4/28/22
9495,1,6,0,7,SCARE06,1206,4/28/22
9496,2,3,2,7,CRAZE16,1218,4/28/22
9497,4,4,3,11,RECON02,1215,4/28/22
9498,1,4,4,9,POST61,1212,4/28/22
9499,1,4,0,5,POST62,1215,4/28/22
9500,2,1,0,3,GHOST21,1242,4/28/22
9501,0,0,0,0,GHOST22,0,4/28/22
9502,2,1,1,4,GHOST22,1245,4/28/22
9503,0,1,3,4,PHNTM69,1230,4/28/22
9504,0,6,5,11,BADGR,1233,4/28/22
9505,0,7,4,11,CRAZE34,1239,4/28/22
9506,2,4,0,6,TORA21,1248,4/28/22
9507,1,4,1,6,TORA22,1251,4/28/22
9508,1,2,1,4,WIRE31,1254,4/28/22
9509,1,2,0,3,WIRE32,1257,4/28/22
9510,1,4,2,7,SCARE13,1306,4/28/22
9511,1,4,1,6,CREEP31,1312,4/28/22
9512,1,4,2,7,CREEP32,1315,4/28/22
9513,1,1,1,3,HOOK11,1300,4/28/22
9514,2,2,2,6,FURY01,1309,4/28/22
9515,4,3,3,10,RECON02,1436,4/28/22
9516,3,1,4,8,DRAGN32,1442,4/28/22
9517,0,5,3,8,RECON03,1439,4/28/22
9518,4,2,1,7,SMALL77,1457,4/28/22
9519,1,5,0,6,SCARE71,1448,4/28/22
9520,1,4,1,6,SCARE06,1454,4/28/22
9521,1,1,4,6,ETCH41,1506,4/28/22
9522,2,1,1,4,ETCH42,1509,4/28/22
9523,2,1,2,5,DRAGN48,1518,4/28/22
9524,2,1,1,4,HANG51,1427,4/28/22
9525,2,1,0,3,HANG52,1430,4/28/22
9526,2,2,4,8,DRAGN47,1521,4/28/22
9527,1,1,3,5,STAB11,1509,4/28/22
9528,1,1,1,3,STAB12,1512,4/28/22
9529,1,5,2,8,SCARE12,1539,4/28/22
9530,0,2,7,9,HOOK71,1536,4/28/22
9531,1,4,4,9,AXLE11,1527,4/28/22
9532,1,4,7,12,AXLE12,1530,4/28/22
9533,0,3,4,7,HOOK41,1524,4/28/22
9534,0,3,4,7,DRAGN72,1545,4/28/22
9535,1,1,3,5,DRAGN03,1548,4/28/22
9536,3,3,1,7,SMALL25,1551,4/28/22
9537,0,3,2,5,AMMO01,803,4/29/22
9538,0,3,4,7,CRAZE,809,4/29/22
9539,0,3,3,6,CRAZE16,806,4/29/22
9540,2,3,3,8,PAWS76,800,4/29/22
9541,2,5,3,10,TAUNT11,815,4/29/22
9542,2,5,3,10,DRAGN01,812,4/29/22
9543,0,5,4,9,BALL14,827,4/29/22
9544,1,2,0,3,EASY81,810,4/29/22
9545,0,3,0,3,LOOT51,842,4/29/22
9546,2,5,2,9,TAUNT21,821,4/29/22
9547,2,5,4,11,TAUNT22,824,4/29/22
9548,0,6,4,10,HOOK32,851,4/29/22
9549,1,3,3,7,RAGTAG1,830,4/29/22
9550,1,3,4,8,RAGTAG1,833,4/29/22
9551,1,7,6,14,HOOK61,903,4/29/22
9552,1,7,2,10,CRAZE55,0,4/29/22
9553,1,5,10,16,HOOK66,906,4/29/22
9554,3,4,8,15,TORA21,857,4/29/22
9555,2,4,7,13,TORA22,9000,4/29/22
9556,0,3,2,5,RAGTAG3,836,4/29/22
9557,0,3,0,3,BALL76,909,4/29/22
9558,0,3,4,7,HOOK37,845,4/29/22
9559,2,3,5,10,FILL31,927,4/29/22
9560,2,3,1,6,FILL32,930,4/29/22
9561,0,2,2,4,BALL24,942,4/29/22
9562,1,6,2,9,COBRA05,948,4/29/22
9563,2,4,1,7,CRAZE41,951,4/29/22
9564,2,5,2,9,COBRA02,954,4/29/22
9565,2,3,5,10,BALL18,1032,4/29/22
9566,0,3,2,5,BALL21,945,4/29/22
9567,0,1,0,1,LOOT69,939,4/29/22
9568,2,5,0,7,COBRA01,927,4/29/22
9569,2,3,1,6,RECON87,1006,4/29/22
9570,0,3,2,5,HOOK38,918,4/29/22
9571,1,5,4,10,RENO71,1009,4/29/22
9572,1,5,2,8,RENO72,1012,4/29/22
9573,1,5,3,9,WIRE31,1000,4/29/22
9574,1,5,1,7,WIRE32,1003,4/29/22
9575,2,8,0,10,BALL89,1148,4/29/22
9576,1,3,1,5,HANG51,1015,4/29/22
9577,0,0,0,0,HANG52,1018,4/29/22
9578,1,3,1,5,HANG52,1018,4/29/22
9579,2,5,1,8,DRAGN31,1021,4/29/22
9580,1,5,2,8,CRAZE33,1024,4/29/22
9581,0,4,5,9,DRAGN22,1033,4/29/22
9582,1,5,2,8,BALL61,1030,4/29/22
9583,1,5,4,10,BALL62,1033,4/29/22
9584,1,6,1,8,SCARE12,1036,4/29/22
9585,2,3,2,7,HOOK14,1100,4/29/22
9586,2,3,2,7,HOOK22,1100,4/29/22
9587,2,4,3,9,STAB11,1100,4/29/22
9588,2,4,0,6,STAB12,1103,4/29/22
9589,1,5,5,11,SPECK02,1106,4/29/22
9590,1,5,5,11,DRAGN53,1109,4/29/22
9591,2,5,1,8,DRAGN52,1111,4/29/22
9592,4,5,1,10,SMALL45,1039,4/29/22
9593,0,5,2,7,AMMO05,1154,4/29/22
9594,0,4,4,8,LOOT06,936,4/29/22
9595,2,3,1,6,DRAGN59,1157,4/29/22
9596,0,5,0,5,BALL77,1200,4/29/22
9597,1,7,4,12,SCARE13,1303,4/29/22
9598,3,5,1,9,WIRE31,1251,4/29/22
9599,2,5,1,8,WIRE32,1254,4/29/22
9600,0,7,1,8,DRAGN65,1300,4/29/22
9601,2,5,3,10,SLOW21,1315,4/29/22
9602,1,5,4,10,SLOW22,1318,4/29/22
9603,2,5,2,9,LOOT55,1257,4/29/22
9604,0,5,1,6,CRAZE47,1309,4/29/22
9605,2,5,4,11,DRAGN47,1312,4/29/22
9606,1,5,2,8,COBRA02,1321,4/29/22
9607,2,7,2,11,COBRA05,1324,4/29/22
9608,0,0,0,0,DRAGN31,14540,4/29/22
9609,0,7,2,9,DRAGN31,1454,4/29/22
9610,1,4,1,6,DRAGN05,16270,4/29/22
9611,2,6,3,11,COBRA01,1203,5/2/22
9612,2,6,4,12,COBRA02,1209,5/2/22
9613,0,8,1,9,BALL19,1239,5/2/22
9614,0,8,2,10,LOOT69,1015,5/2/22
9615,1,10,1,12,ETCH41,1118,5/2/22
9616,1,10,3,14,ETCH42,1121,5/2/22
9617,2,4,4,10,VEGA21,1018,5/2/22
9618,0,7,1,8,COBRA08,1006,5/2/22
9619,2,4,1,7,VEGA22,1021,5/2/22
9620,1,9,1,11,BALL58,1027,5/2/22
9621,3,3,4,10,COBRA05,1009,5/2/22
9622,0,7,0,7,SPECK69,1300,5/2/22
9623,2,5,0,7,TORA 21,1306,5/2/22
9624,1,5,0,6,TORA22,1309,5/2/22
9625,2,1,0,3,WIRE31,1315,5/2/22
9626,2,1,0,3,WIRE32,1318,5/2/22
9627,1,8,3,12,HOOK01,1312,5/2/22
9628,0,5,1,6,RECON99,1012,5/2/22
9629,1,9,0,10,FILL31,1124,5/2/22
9630,1,9,1,11,FILL32,1127,5/2/22
9631,0,6,0,6,BALL61,1033,5/2/22
9632,1,3,9,13,SHINR81,821,5/3/22
9633,1,3,8,12,SHINR82,824,5/3/22
9634,2,2,1,5,DAWG02,806,5/3/22
9635,0,5,1,6,BALL19,836,5/3/22
9636,0,2,3,5,AMMO 01,839,5/3/22
9637,0,5,3,8,PAWS 76,833,5/3/22
9638,0,8,5,13,BALL 18,830,5/3/22
9639,0,5,6,11,FURY 02,827,5/3/22
9640,0,3,4,7,BADGR 02,848,5/3/22
9641,0,4,1,5,BADGR 09,854,5/3/22
9642,2,3,3,8,BADGR 04,845,5/3/22
9643,2,3,2,7,CRAZE 42,857,5/3/22
9644,0,3,2,5,FURY 04,851,5/3/22
9645,1,2,0,3,RECON 69,912,5/3/22
9646,2,3,1,6,OUZO 11,748,5/3/22
9647,2,3,5,10,OUZO 12,748,5/3/22
9648,2,3,5,10,DRAGN 33,927,5/3/22
9649,0,4,0,4,BALL 81,907,5/3/22
9650,0,1,1,2,HOOK 91,915,5/3/22
9651,2,3,2,7,DRAGN 48,936,5/3/22
9652,1,3,2,6,DRAGN 05,933,5/3/22
9653,1,1,1,3,CRAZE 88,930,5/3/22
9654,0,5,0,5,DRAGN 61,939,5/3/22
9655,0,1,0,1,RECON 89,906,5/3/22
9656,2,2,1,5,POST 11,942,5/3/22
9657,2,2,2,6,POST 12,942,5/3/22
9658,0,4,2,6,DRAGN 01,954,5/3/22
9659,1,2,1,4,RENO 71,1000,5/3/22
9660,1,2,1,4,RENO 72,1000,5/3/22
9661,0,1,1,2,CRAZE 47,927,5/3/22
9662,0,4,0,4,HOOK 65,951,5/3/22
9663,1,3,1,5,WIRE 31,1006,5/3/22
9664,1,3,4,8,WIRE 32,1006,5/3/22
9665,1,2,0,3,TAUNT 21,1100,5/3/22
9666,1,2,1,4,TAUNT 22,1100,5/3/22
9667,0,1,0,1,DRAGN 59,951,5/3/22
9668,1,3,3,7,TORA 11,1030,5/3/22
9669,1,3,1,5,TORA 12,1032,5/3/22
9670,1,3,3,7,LOST 81,1012,5/3/22
9671,1,3,2,6,LOST 82,1012,5/3/22
9672,0,2,2,4,DRAGN 32,1121,5/3/22
9673,1,5,0,6,GIZMO 51,1115,5/3/22
9674,1,5,2,8,GIZMO 51,1118,5/3/22
9675,2,2,1,5,SMALL64,1124,5/3/22
9676,3,4,2,9,DRAGN38,1127,5/3/22
9677,1,3,1,5,DRAGN37,1130,5/3/22
9678,2,2,3,7,DRAGN71,1133,5/3/22
9679,1,2,0,3,HANG51,1136,5/3/22
9680,1,2,1,4,HANG52,1139,5/3/22
9681,1,2,4,7,COBRA02,1148,5/3/22
9682,0,4,0,4,HOOK14,1142,5/3/22
9683,1,0,1,2,COBRA04,1145,5/3/22
9684,1,0,1,2,BALL02,1206,5/3/22
9685,2,4,2,8,SCARE21,1151,5/3/22
9686,3,0,3,6,DAWG02,1154,5/3/22
9687,5,3,2,10,BALL79,1200,5/3/22
9688,0,3,2,5,CRAZE14,1203,5/3/22
9689,1,5,1,7,HOOK68,1157,5/3/22
9690,2,2,2,6,BALL19,1224,5/3/22
9691,2,2,3,7,BALL89,1230,5/3/22
9692,0,5,3,8,CRAZE76,1227,5/3/22
9693,0,3,2,5,CRAZE54,1239,5/3/22
9694,3,4,5,12,SCARE72,1236,5/3/22
9695,0,4,3,7,BADGR04,1242,5/3/22
9696,2,2,3,7,CRAZE42,1251,5/3/22
9697,0,3,3,6,BADGR02,1245,5/3/22
9698,0,0,2,2,CRAZE16,1248,5/3/22
9699,0,2,4,6,CRAZE88,1300,5/3/22
9700,1,4,2,7,DRAGN06,1303,5/3/22
9701,1,4,2,7,DRAGN48,1306,5/3/22
9702,1,4,2,7,RECON87,1309,5/3/22
9703,2,5,1,8,DRAGON44,1436,5/3/22
9704,4,3,2,9,SMALL79,1439,5/3/22
9705,0,2,3,5,CRAZE47,1454,5/3/22
9706,2,4,4,10,HOOK66,1442,5/3/22
9707,0,4,5,9,DRAGN03,1457,5/3/22
9708,0,7,1,8,DRAGN65,1445,5/3/22
9709,3,3,0,6,SMALL04,1500,5/3/22
9710,0,6,4,10,DRAGN71,1448,5/3/22
9711,0,3,2,5,DRAGN32,1503,5/3/22
9712,1,3,2,6,COBRA05,0,5/3/22
9713,0,3,2,5,RECON99,1500,5/3/22
9714,0,4,7,11,DRAGN37,1512,5/3/22
9715,2,4,1,7,HOOK99,1515,5/3/22
9716,0,4,9,13,DRAGN38,1509,5/3/22
9717,4,5,0,9,SMALL15,1527,5/3/22
9718,1,5,2,8,VEGA21,1518,5/3/22
9719,1,5,2,8,VEGA22,1521,5/3/22
9720,3,4,0,7,SMALL20,1536,5/3/22
9721,2,4,4,10,HANG51,1715,5/3/22
9722,2,4,1,7,HANG52,1718,5/3/22
9723,0,7,0,7,BALL 52,1230,5/5/22
9724,0,7,1,8,BALL 56,1233,5/5/22
9725,8,6,7,21,DRAGN32,1603,5/5/22
9726,1,6,4,11,DRAGN 37,1609,5/5/22
9727,0,9,4,13,DRAGN71,1600,5/5/22
9728,1,1,4,6,easy11,831,5/6/22
9729,1,2,3,6,Cobra05,830,5/6/22
9730,2,2,3,7,Recon99,833,5/6/22
9731,2,2,2,6,Craze41,836,5/6/22
9732,3,1,3,7,Recon02,848,5/6/22
9733,2,2,1,5,Paws81,839,5/6/22
9734,1,2,0,3,paws82,839,5/6/22
9735,3,2,1,6,Small75,851,5/6/22
9736,1,2,1,4,Shinr81,854,5/6/22
9737,1,2,5,8,Shinr82,854,5/6/22
9738,1,3,3,7,Ball14,845,5/6/22
9739,0,2,3,5,CRAZE76,909,5/6/22
9740,2,3,3,8,FURY01,900,5/6/22
9741,1,2,0,3,RECON89,906,5/6/22
9742,2,2,1,5,RECON69,921,5/6/22
9743,0,1,0,1,DRAGN81,903,5/6/22
9744,3,2,0,5,SMALL10,912,5/6/22
9745,3,2,1,6,SMALL11,915,5/6/22
9746,4,1,0,5,SMALL12,918,5/6/22
9747,1,2,3,6,COACH21,930,5/6/22
9748,4,2,0,6,COACH21,930,5/6/22
9749,2,2,2,6,FILL91,936,5/6/22
9750,2,2,1,5,FILL92,939,5/6/22
9751,1,1,0,2,DRAGN96,945,5/6/22
9752,0,2,2,4,DRAGN99,942,5/6/22
9753,3,3,3,9,HANG51,924,5/6/22
9754,3,3,2,8,HANG52,924,5/6/22
9755,3,1,2,6,CRAZE88,1006,5/6/22
9756,1,2,1,4,SCARE18,1009,5/6/22
9757,2,2,1,5,CRAZE47,948,5/6/22
9758,1,2,2,5,VEGA21,951,5/6/22
9759,2,2,3,7,VEGA22,954,5/6/22
9760,0,2,2,4,DRAGN23,9570,5/6/22
9761,0,1,5,6,DRAGN38,1000,5/6/22
9762,1,2,0,3,DRAGN06,1003,5/6/22
9763,2,2,0,4,AXLE11,1012,5/6/22
9764,2,2,4,8,AXLE12,1012,5/6/22
9765,1,2,0,3,SCARE52,1021,5/6/22
9766,1,2,3,6,OUZO11,1024,5/6/22
9767,1,2,3,6,OUZU11,1024,5/6/22
9768,0,1,3,4,DRAGN75,1024,5/6/22
9769,1,2,1,4,TORA11,1030,5/6/22
9770,1,2,1,4,TORA12,1033,5/6/22
9771,2,2,0,4,GOLEM21,1049,5/6/22
9772,1,2,0,3,GOLEM22,1048,5/6/22
9773,1,4,5,10,FILL31,1036,5/6/22
9774,1,4,3,8,FILL32,1039,5/6/22
9775,0,2,1,3,BALL58,1045,5/6/22
9776,2,2,2,6,LOST11,1054,5/6/22
9777,1,2,0,3,LOST12,1057,5/6/22
9778,2,2,1,5,RAGTAG1,1100,5/6/22
9779,2,2,2,6,RAGTAG1,1100,5/6/22
9780,0,2,0,2,HOOK61,1145,5/6/22
9781,1,2,6,9,RENO71,1157,5/6/22
9782,4,2,0,6,RENO72,1200,5/6/22
9783,2,2,2,6,DRAGN32,1206,5/6/22
9784,1,2,4,7,GIZMO51,1151,5/6/22
9785,1,2,1,4,GIZMO52,1154,5/6/22
9786,0,2,1,3,DRAGN31,1203,5/6/22
9787,3,2,4,9,DRAGN37,1209,5/6/22
9788,1,5,1,7,PAWS66,1148,5/6/22
9789,3,2,0,5,SMALL10,1212,5/6/22
9790,2,2,3,7,COBRA02,1215,5/6/22
9791,1,2,3,6,COBRA05,1218,5/6/22
9792,0,2,1,3,AMMO02,1245,5/6/22
9793,4,2,0,6,SMALL27,1257,5/6/22
9794,1,2,3,6,SCARE21,1239,5/6/22
9795,1,2,1,4,COACH21,1224,5/6/22
9796,1,2,2,5,COACH22,1227,5/6/22
9797,1,1,3,5,EASY85,1216,5/6/22
9798,0,2,2,4,BADGR04,1251,5/6/22
9799,4,2,2,8,CREEP31,1233,5/6/22
9800,4,2,1,7,CREEP32,1236,5/6/22
9801,1,2,3,6,BALL61,1230,5/6/22
9802,0,2,2,4,LOOT69,1242,5/6/22
9803,3,2,0,5,SMALL26,1254,5/6/22
9804,0,2,2,4,CRAZE76,1248,5/6/22
9805,0,2,1,3,RECON69,1300,5/6/22
9806,0,2,2,4,HOOK62,1309,5/6/22
9807,4,2,3,9,DRAGN01,1312,5/6/22
9808,1,2,2,5,AXLE11,1327,5/6/22
9809,1,2,2,5,AXLE12,1330,5/6/22
9810,2,2,3,7,HOOK22,1321,5/6/22
9811,0,2,4,6,PHNTM14,1324,5/6/22
9812,0,2,3,5,BALL82,1336,5/6/22
9813,3,0,4,7,SMALL46,1342,5/6/22
9814,1,0,2,3,EASY42,1335,5/6/22
9815,0,0,0,0,CRAZE88,1306,5/6/22
9816,0,1,1,2,BALL89,1336,5/6/22
9817,0,1,2,3,HOOK61,1430,5/6/22
9818,0,2,0,2,HOOK91,1339,5/6/22
9819,2,2,5,9,ETCH41,1512,5/6/22
9820,2,2,3,7,ETCH42,1515,5/6/22
9821,5,2,1,8,DRAGN44,1518,5/6/22
9822,0,2,4,6,DRAGN41,1536,5/6/22
9823,1,1,2,4,VEGA21,1521,5/6/22
9824,1,1,6,8,VEGA22,1524,5/6/22
9825,0,2,6,8,DRAGN03,1533,5/6/22
9826,3,2,1,6,SMALL16,1530,5/6/22
9827,1,0,1,2,EASY11,1516,5/6/22
9828,2,2,4,8,DRAGN32,1545,5/6/22
9829,0,2,6,8,DRAGN37,1548,5/6/22
9830,0,2,4,6,DRAGN75,1527,5/6/22
9831,4,0,3,7,SMALL21,1539,5/6/22
9832,3,0,1,4,SMALL93,1542,5/6/22
9833,3,0,2,5,SMALL25,1551,5/6/22
9834,2,0,1,3,BALL56,1600,5/6/22
9835,1,0,2,3,BALL52,1557,5/6/22
9836,1,0,0,1,HOOK21,1554,5/6/22
9837,1,1,6,8,SCARE18,806,5/9/22
9838,2,1,5,8,DRAGN31,809,5/9/22
9839,0,1,5,6,PHNTM14,818,5/9/22
9840,3,0,2,5,SMALL78,824,5/9/22
9841,3,1,2,6,SMALL65,827,5/9/22
9842,1,1,5,7,DRAGN37,821,5/9/22
9843,1,1,5,7,HOOK23,815,5/9/22
9844,2,4,3,9,AXLE33,830,5/9/22
9845,2,4,1,7,AXLE33,830,5/9/22
9846,1,1,1,3,DRAGN17,836,5/9/22
9847,1,2,2,5,RHINO99,800,5/9/22
9848,1,2,0,3,RHINO,800,5/9/22
9849,2,3,5,10,RENO71,845,5/9/22
9850,1,3,2,6,RENO72,845,5/9/22
9851,0,3,6,9,HOOK03,842,5/9/22
9852,1,2,2,5,WIRE31,854,5/9/22
9853,1,2,5,8,WIRE31,854,5/9/22
9854,0,3,1,4,HOOK69,851,5/9/22
9855,1,3,0,4,CRAZE54,900,5/9/22
9856,1,1,6,8,RECON82,903,5/9/22
9857,1,3,1,5,DRAGN91,909,5/9/22
9858,1,3,4,8,DRAGN13,906,5/9/22
9859,1,1,2,4,CRAZE25,918,5/9/22
9860,0,3,0,3,BALL19,922,5/9/22
9861,0,3,1,4,BADGR04,933,5/9/22
9862,2,3,0,5,BALL15,924,5/9/22
9863,0,4,7,11,BALL18,927,5/9/22
9864,0,1,3,4,BADGR09,930,5/9/22
9865,1,2,2,5,BADGR02,936,5/9/22
9866,2,4,0,6,CRAZE16,945,5/9/22
9867,1,4,1,6,PHNTM45,948,5/9/22
9868,0,1,1,2,BADGR01,936,5/9/22
9869,3,2,2,7,BALL04,942,5/9/22
9870,2,3,3,8,COBRA05,954,5/9/22
9871,2,2,3,7,CRAZE46,957,5/9/22
9872,2,6,2,10,FILL31,1018,5/9/22
9873,2,6,4,12,FILL32,1018,5/9/22
9874,1,4,1,6,GIZMO51,1012,5/9/22
9875,1,4,3,8,GIZMO51,1015,5/9/22
9876,2,3,0,5,TORA71,1030,5/9/22
9877,2,3,0,5,TORA72,1033,5/9/22
9878,3,1,3,7,MANLY1,1000,5/9/22
9879,2,1,3,6,MANLY1,1006,5/9/22
9880,1,4,2,7,GOLEM61,1024,5/9/22
9881,1,4,2,7,GOLEM62,1027,5/9/22
9882,2,3,1,6,RECON87,1203,5/9/22
9883,0,6,1,7,BALL52,1136,5/9/22
9884,1,4,2,7,TAUNT11,1148,5/9/22
9885,1,4,3,8,TAUNT12,1157,5/9/22
9886,2,3,2,7,GIZMO21,1139,5/9/22
9887,1,3,2,6,GIZMO22,1145,5/9/22
9888,1,2,4,7,DRAGN 02,1154,5/9/22
9889,1,4,2,7,LOST 31,1148,5/9/22
9890,1,2,4,7,RECON39,1206,5/9/22
9891,0,4,0,4,BALL14,1221,5/9/22
9892,1,4,2,7,LOST32,1148,5/9/22
9893,1,2,0,3,CRAZE88,1230,5/9/22
9894,2,4,6,12,DRAGN37,1209,5/9/22
9895,1,3,0,4,SHINR81,1212,5/9/22
9896,4,3,0,7,SHINR82,1212,5/9/22
9897,0,6,2,8,GHOST02,1218,5/9/22
9898,2,4,6,12,DAWG01,1200,5/9/22
9899,3,2,2,7,DRAGN41,1239,5/9/22
9900,0,2,5,7,HOOK23,1236,5/9/22
9901,0,2,7,9,DRAGN13,1227,5/9/22
9902,3,2,3,8,SMALL17,1233,5/9/22
9903,1,4,2,7,HANG51,1245,5/9/22
9904,1,4,4,9,HANG52,1245,5/9/22
9905,4,3,1,8,DRAGN44,1242,5/9/22
9906,0,3,4,7,DRAGN03,1251,5/9/22
9907,1,4,5,10,RENO71,1254,5/9/22
9908,3,4,6,13,TORA21,1300,5/9/22
9909,1,4,5,10,RENO72,1254,5/9/22
9910,0,1,1,2,AMMO09,1530,5/9/22
9911,1,4,6,11,SCARE77,1321,5/9/22
9912,0,1,7,8,RECON82,1312,5/9/22
9913,2,4,4,10,AXLE11,1315,5/9/22
9914,2,4,7,13,AXLE12,1315,5/9/22
9915,1,2,4,7,CRAZE25,1324,5/9/22
9916,0,4,2,6,AMMO05,1333,5/9/22
9917,2,2,4,8,BALL18,1327,5/9/22
9918,1,4,0,5,SCARE64,1457,5/9/22
9919,3,4,0,7,SCARE69,1454,5/9/22
9920,2,4,1,7,PHNTM69,1503,5/9/22
9921,2,4,2,8,CRAZE16,1506,5/9/22
9922,0,5,3,8,BADGR02,1500,5/9/22
9923,3,1,1,5,SMALL07,1509,5/9/22
9924,0,5,6,11,DRAGN32,1512,5/9/22
9925,1,3,5,9,COBRA05,1521,5/9/22
9926,1,5,1,7,COBRA02,1524,5/9/22
9927,0,5,6,11,DRAGN38,1533,5/9/22
9928,1,5,2,8,COBRA01,1527,5/9/22
9929,1,3,1,5,CRAZE34,1515,5/9/22
9930,2,4,4,10,RECON87,1539,5/9/22
9931,2,3,2,7,BALL34,1518,5/9/22
9932,4,3,1,8,DAWG02,1530,5/9/22
9933,1,5,3,9,RENO71,1545,5/9/22
9934,1,5,3,9,RENO72,1545,5/9/22
9935,1,5,3,9,WIRE51,1554,5/9/22
9936,0,3,3,6,Dawg 04,1536,5/9/22
9937,1,1,4,6,Vega 21,951,5/10/22
9938,1,1,3,5,Vega 22,951,5/10/22
9939,1,2,0,3,DRAGN 91,945,5/10/22
9940,2,2,4,8,DRAGN 37,957,5/10/22
9941,2,4,2,8,AXLE 11,1003,5/10/22
9942,2,4,1,7,AXLE 12,1003,5/10/22
9943,0,2,1,3,BALL 88,803,5/10/22
9944,1,2,5,8,DRAGN 33,824,5/10/22
9945,0,4,3,7,DRAGN 38,815,5/10/22
9946,1,1,5,7,DRAGN 53,830,5/10/22
9947,2,3,5,10,DRAGN 48,827,5/10/22
9948,0,3,3,6,DRAGN 97,836,5/10/22
9949,0,3,4,7,DRAGN 77,842,5/10/22
9950,0,5,7,12,DRAGN 71,839,5/10/22
9951,1,2,6,9,Hook 66,848,5/10/22
9952,2,3,3,8,DRAGN 61,854,5/10/22
9953,0,2,3,5,DRAGN 65,851,5/10/22
9954,0,2,2,4,Hook 62,845,5/10/22
9955,3,4,2,9,Filly 41,903,5/10/22
9956,2,4,3,9,Filly 42,906,5/10/22
9957,0,3,3,6,Ball 19,912,5/10/22
9958,1,3,0,4,AMMO 06,918,5/10/22
9959,2,3,1,6,Ball 79,909,5/10/22
9960,3,2,1,6,Small 78,930,5/10/22
9961,3,3,0,6,Small 61,915,5/10/22
9962,2,3,1,6,BADGR 04,936,5/10/22
9963,0,2,2,4,Ball 15,921,5/10/22
9964,0,1,2,3,CRAZE 25,924,5/10/22
9965,0,3,1,4,PHNTM 69,933,5/10/22
9966,0,1,4,5,PHNTM,927,5/10/22
9967,1,2,3,6,SCARE 72,939,5/10/22
9968,2,2,1,5,CRAZE 16,942,5/10/22
9969,1,4,1,6,COBRA 02,954,5/10/22
9970,2,3,4,9,CRAZE 42,957,5/10/22
9971,1,2,0,3,CRAZE 46,951,5/10/22
9972,1,2,1,4,Cobra 08,948,5/10/22
9973,1,1,2,4,BADGR 09,945,5/10/22
9974,1,4,2,7,GIZMO 21,1009,5/10/22
9975,1,4,2,7,GIZMO 22,1012,5/10/22
9976,1,5,3,9,BALL 63,1000,5/10/22
9977,1,4,0,5,PAWS 15,1006,5/10/22
9978,1,5,2,8,FILL 31,1018,5/10/22
9979,1,5,6,12,FILL 32,1021,5/10/22
9980,5,1,3,9,BALL 44,1003,5/10/22
9981,0,4,1,5,Hook 72,1024,5/10/22
9982,2,0,1,3,Hook 05,1015,5/10/22
9983,1,3,3,7,PAWS 47,1027,5/10/22
9984,2,4,1,7,SLOW11,1142,5/10/22
9985,1,4,2,7,SLOW12,1142,5/10/22
9986,1,5,3,9,TUANT21,1130,5/10/22
9987,1,2,3,6,GOLEM11,1136,5/10/22
9988,1,4,6,11,GOLEM22,1136,5/10/22
9989,1,2,2,5,CREEP31,1148,5/10/22
9990,1,2,1,4,CREEP32,1148,5/10/22
9991,3,1,5,9,RECON99,1154,5/10/22
9992,4,4,0,8,DRAGN01,1157,5/10/22
9993,1,2,1,4,SCARE76,1203,5/10/22
9994,2,4,6,12,DRAGN37,1200,5/10/22
9995,1,2,4,7,WIRE31,1209,5/10/22
9996,2,2,4,8,WIRE32,1209,5/10/22
9997,1,5,1,7,HANG51,1206,5/10/22
9998,1,5,4,10,HNAG52,1206,5/10/22
9999,2,2,2,6,RENO71,1215,5/10/22
10000,1,2,2,5,RENO72,1215,5/10/22
10001,3,4,4,11,SMALL15,1227,5/10/22
10002,2,2,3,7,SMALL24,1250,5/10/22
10003,2,4,7,13,DRAGN33,1233,5/10/22
10004,0,4,3,7,DRAGN41,1236,5/10/22
10005,2,4,1,7,DRAGN81,1245,5/10/22
10006,0,3,6,9,DRAGN38,1230,5/10/22
10007,1,4,4,9,DRAGN06,1239,5/10/22
10008,1,4,6,11,DRAGN48,1242,5/10/22
10009,1,1,7,9,DRAGN53,1248,5/10/22
10010,0,4,6,10,DRAGN71,1257,5/10/22
10011,0,2,3,5,DRAGN75,1251,5/10/22
10012,0,4,4,8,DRAGN65,1312,5/10/22
10013,0,3,4,7,RECON88,1300,5/10/22
10014,1,3,3,7,STAB11,1315,5/10/22
10015,2,3,6,11,STAB12,1315,5/10/22
10016,4,3,1,8,SMALL88,1324,5/10/22
10017,1,1,0,2,CRAZE76,1327,5/10/22
10018,2,3,2,7,RECON87,1306,5/10/22
10019,0,1,1,2,AMMO09,1330,5/10/22
10020,2,3,0,5,CRAZE88,1303,5/10/22
10021,3,2,1,6,SMALL43,1333,5/10/22
10022,0,5,0,5,DRAGN69,1321,5/10/22
10023,0,5,3,8,BADGR04,1451,5/10/22
10024,0,3,2,5,CRAZE16,1503,5/10/22
10025,0,3,2,5,BADGR02,1554,5/10/22
10026,3,3,1,7,SMALL74,1448,5/10/22
10027,2,3,1,6,TORA11,1506,5/10/22
10028,2,3,2,7,TORA12,1506,5/10/22
10029,2,3,4,9,DAWG04,1521,5/10/22
10030,1,4,3,8,CRAZE46,1512,5/10/22
10031,3,3,0,6,SMALL14,1524,5/10/22
10032,1,5,4,10,PAWS15,1515,5/10/22
10033,1,4,3,8,RECON99,1527,5/10/22
10034,2,2,1,5,DAWG02,1530,5/10/22
10035,1,5,1,7,CRAZE34,1542,5/10/22
10036,0,5,2,7,FURY04,1548,5/10/22
10037,0,3,1,4,CRAZE76,1545,5/10/22
10038,1,1,4,6,VEGA21,812,5/11/22
10039,1,1,3,5,VEGA22,815,5/11/22
10040,0,3,5,8,PHNTM14,809,5/11/22
10041,3,1,1,5,SMALL62,818,5/11/22
10042,1,3,5,9,SCARE13,821,5/11/22
10043,1,4,4,9,DRAGN41,827,5/11/22
10044,3,3,1,7,SMALL70,836,5/11/22
10045,1,2,5,8,DRAGN48,824,5/11/22
10046,1,2,6,9,DRAGN33,830,5/11/22
10047,0,3,3,6,DRAGN37,833,5/11/22
10048,1,3,5,9,DRAGN53,839,5/11/22
10049,0,5,5,10,DRAGN75,851,5/11/22
10050,3,1,2,6,SMALL73,845,5/11/22
10051,1,4,2,7,AXLE11,854,5/11/22
10052,1,4,4,9,AXLE12,857,5/11/22
10053,1,4,5,10,DRAGN71,848,5/11/22
10054,0,4,2,6,HOOK62,851,5/11/22
10055,2,4,2,8,STAB11,903,5/11/22
10056,2,4,0,6,STAB12,906,5/11/22
10057,0,5,2,7,PHNTM69,939,5/11/22
10058,4,2,2,8,CRAZE25,915,5/11/22
10059,3,5,1,9,SCARE64,933,5/11/22
10060,1,4,2,7,SCARE77,927,5/11/22
10061,0,0,1,1,HOOK05,1000,5/11/22
10062,2,1,5,8,WIRE31,921,5/11/22
10063,2,1,1,4,WIRE32,924,5/11/22
10064,1,1,0,2,EASY42,931,5/11/22
10065,1,1,3,5,SCARE76,945,5/11/22
10066,1,1,0,2,EASY31,0,5/11/22
10067,0,1,0,1,PAWS55,800,5/11/22
10068,1,2,1,4,BADGR02,942,5/11/22
10069,1,3,1,5,COBRA02,1000,5/11/22
10070,2,0,2,4,PHNTM50,957,5/11/22
10071,1,2,1,4,POST61,948,5/11/22
10072,1,2,0,3,POST62,957,5/11/22
10073,1,0,0,1,COBRA08,954,5/11/22
10074,1,1,1,3,COBRA05,1003,5/11/22
10075,3,3,2,8,SLOW18,1012,5/11/22
10076,1,2,3,6,SLOW19,1015,5/11/22
10077,2,2,0,4,SLOW51,1018,5/11/22
10078,2,2,1,5,SLOW52,1021,5/11/22
10079,1,4,3,8,GOLEM61,1024,5/11/22
10080,1,4,6,11,GOLEM62,1024,5/11/22
10081,3,1,4,8,PAWS47,1030,5/11/22
10082,1,3,1,5,CREEP31,1130,5/11/22
10083,4,3,0,7,CREEP32,1133,5/11/22
10084,3,3,1,7,SMALL71,1139,5/11/22
10085,3,4,1,8,SMALL72,1142,5/11/22
10086,1,3,0,4,TORA31,1142,5/11/22
10087,1,3,0,4,TORA31,1145,5/11/22
10088,1,1,0,2,BALL79,1157,5/11/22
10089,4,1,1,6,BALL88,1151,5/11/22
10090,1,2,1,4,EASY31,1201,5/11/22
10091,1,3,2,6,DAWG01,1203,5/11/22
10092,4,3,0,7,BALL87,1200,5/11/22
10093,1,4,1,6,SHINR81,1212,5/11/22
10094,1,4,4,9,SHINR82,1215,5/11/22
10095,1,1,0,2,COACH21,1218,5/11/22
10096,1,1,0,2,COACH22,1221,5/11/22
10097,0,2,1,3,BALL63,1209,5/11/22
10098,1,4,1,6,SCARE36,1242,5/11/22
10099,2,2,7,11,DRAGN37,1239,5/11/22
10100,0,2,5,7,DRAGN13,1236,5/11/22
10101,2,1,3,6,CRAZE88,1230,5/11/22
10102,1,2,5,8,VEGA21,1224,5/11/22
10103,2,2,6,10,VEGA22,1227,5/11/22
10104,2,2,6,10,DRAGN48,1245,5/11/22
10105,0,3,1,4,AMMO09,1300,5/11/22
10106,2,4,6,12,DRAGN33,1251,5/11/22
10107,1,2,3,6,DRAGN06,1248,5/11/22
10108,1,1,0,2,HOOK91,1257,5/11/22
10109,0,4,1,5,HOOK68,1303,5/11/22
10110,3,2,1,6,SMALL33,1309,5/11/22
10111,0,2,2,4,DRAGN62,1306,5/11/22
10112,3,5,1,9,SMALL36,1318,5/11/22
10113,1,1,6,8,DRAGN53,1312,5/11/22
10114,0,4,2,6,CRAZE44,1327,5/11/22
10115,1,4,6,11,HANG51,1321,5/11/22
10116,1,4,7,12,HANG52,1324,5/11/22
10117,1,2,2,5,HYDRA91,1333,5/11/22
10118,1,2,2,5,HYDRA92,1336,5/11/22
10119,2,2,5,9,DRAGN54,1315,5/11/22
10120,1,3,4,8,SCARE38,1339,5/11/22
10121,0,1,1,2,BADGR03,1330,5/11/22
10122,0,4,1,5,LOOT77,1438,5/11/22
10123,4,2,3,9,PAWS25,1433,5/11/22
10124,1,2,1,4,SCARE02,1442,5/11/22
10125,0,2,3,5,AMMO05,1439,5/11/22
10126,1,1,1,3,AMMO06,1506,5/11/22
10127,0,1,4,5,BADGR04,1457,5/11/22
10128,0,4,1,5,CRAZE16,1503,5/11/22
10129,0,1,1,2,BALL69,1500,5/11/22
10130,3,2,2,7,SMALL10,1512,5/11/22
10131,0,2,0,2,LOOT06,1454,5/11/22
10132,3,2,0,5,SCARE72,1509,5/11/22
10133,1,4,3,8,PHNTM50,1521,5/11/22
10134,1,2,3,6,COBRA06,1515,5/11/22
10135,1,4,2,7,COBRA02,1524,5/11/22
10136,1,1,1,3,CRAZE46,1527,5/11/22
10137,1,4,2,7,AXLE11,1527,5/11/22
10138,4,4,2,10,AXLE12,1527,5/11/22
10139,2,3,2,7,RECON87,1533,5/11/22
10140,1,3,2,6,DAWG01,1539,5/11/22
10141,1,4,1,6,COACH21,1612,5/11/22
10142,4,4,2,10,COACH21,1615,5/11/22
10143,4,2,2,8,BALL79,1542,5/11/22
10144,1,1,4,6,DAWG04,1536,5/11/22
10145,1,4,2,7,SHINR81,1548,5/11/22
10146,4,4,2,10,SHINR82,1551,5/11/22
10147,1,1,3,5,VEGA21,803,5/12/22
10148,1,1,4,6,VEGA22,806,5/12/22
10149,0,1,5,6,HOOK22,809,5/12/22
10150,1,2,3,6,RENO71,815,5/12/22
10151,1,2,3,6,RENO72,815,5/12/22
10152,0,3,4,7,DRAGN77,812,5/12/22
10153,2,2,6,10,DRAGN33,827,5/12/22
10154,2,3,6,11,DRAGN48,830,5/12/22
10155,0,2,4,6,DRAGN38,821,5/12/22
10156,0,3,4,7,DRAGN71,824,5/12/22
10157,0,1,3,4,RHINO99,800,5/12/22
10158,1,3,5,9,SCARE18,845,5/12/22
10159,3,1,4,8,BALL18,842,5/12/22
10160,1,1,3,5,DRAGN44,836,5/12/22
10161,1,3,3,7,SCARE06,851,5/12/22
10162,2,2,4,8,PAWS25,839,5/12/22
10163,0,1,4,5,DEAGN97,848,5/12/22
10164,0,3,6,9,HOOK66,854,5/12/22
10165,2,1,1,4,SMALL77,857,5/12/22
10166,0,2,4,6,DRAGN32,903,5/12/22
10167,2,1,3,6,RECON89,909,5/12/22
10168,0,0,4,4,DRAGN37,833,5/12/22
10169,2,2,2,6,HOOK68,906,5/12/22
10170,2,2,2,6,DRAGN91,900,5/12/22
10171,3,0,1,4,CRAZE79,918,5/12/22
10172,0,0,2,2,EPIC09,912,5/12/22
10173,2,3,1,6,GIZMO51,930,5/12/22
10174,2,3,0,5,GIZMO52,933,5/12/22
10175,2,0,1,3,BADGR04,945,5/12/22
10176,0,1,2,3,DRAGN03,915,5/12/22
10177,3,2,1,6,BALL16,942,5/12/22
10178,1,3,1,5,SCARE76,909,5/12/22
10179,0,1,0,1,BALL19,936,5/12/22
10180,1,3,2,6,BADGR02,948,5/12/22
10181,4,1,0,5,CRAZE16,945,5/12/22
10182,4,3,2,9,SMALL26,954,5/12/22
10183,1,3,0,4,PHNTM50,1009,5/12/22
10184,1,1,4,6,COBRA06,1006,5/12/22
10185,2,3,1,6,SLOW11,1015,5/12/22
10186,1,3,1,5,SLOW12,1018,5/12/22
10187,1,1,3,5,CRAZE46,1012,5/12/22
10188,1,3,5,9,FILL31,1021,5/12/22
10189,1,3,4,8,FILL32,1024,5/12/22
10190,2,4,1,7,PAWS44,1027,5/12/22
10191,0,3,2,5,HOOK75,1030,5/12/22
10192,1,4,2,7,TORA21,1133,5/12/22
10193,1,4,0,5,TORA22,1136,5/12/22
10194,1,4,1,6,COACH21,1139,5/12/22
10195,1,4,2,7,COACH22,1142,5/12/22
10196,3,3,2,8,DRAGN01,1151,5/12/22
10197,0,3,3,6,CRAZE47,1209,5/12/22
10198,1,1,0,2,RECON77,1157,5/12/22
10199,1,2,4,7,DAWG04,1154,5/12/22
10200,2,4,1,7,DAWG02,1200,5/12/22
10201,0,4,4,8,SPECK02,1203,5/12/22
10202,0,2,7,9,DRAGN37,1215,5/12/22
10203,2,6,2,10,LOST81,1145,5/12/22
10204,2,6,2,10,LOST82,1148,5/12/22
10205,1,4,2,7,WIRE31,1218,5/12/22
10206,4,4,1,9,WIRE32,1221,5/12/22
10207,2,2,4,8,STAB11,1224,5/12/22
10208,2,2,6,10,STAB12,1227,5/12/22
10209,1,2,5,8,VEGA21,1230,5/12/22
10210,1,2,3,6,VEGA22,1233,5/12/22
10211,0,1,1,2,CRAZE79,1139,5/12/22
10212,1,2,4,7,DRAGN32,1236,5/12/22
10213,1,2,7,10,DRAGN33,1245,5/12/22
10214,0,4,3,7,BALL61,1242,5/12/22
10215,3,2,2,7,DRAGN59,1251,5/12/22
10216,2,2,8,12,DRAGN48,1248,5/12/22
10217,1,4,4,9,SCARE38,1254,5/12/22
10218,3,4,1,8,BALL88,1303,5/12/22
10219,1,2,4,7,RECON89,1300,5/12/22
10220,0,4,2,6,FURY03,1257,5/12/22
10221,4,3,0,7,DRAGN12,1309,5/12/22
10222,0,2,0,2,BALL79,1306,5/12/22
10223,3,2,4,9,BALL04,1312,5/12/22
10224,1,2,0,3,CRAZE34,1318,5/12/22
10225,2,2,5,9,DRAGN53,1321,5/12/22
10226,1,4,3,8,HANG51,1324,5/12/22
10227,1,4,5,10,Hang52,1327,5/12/22
10228,1,2,3,6,RENO71,1330,5/12/22
10229,1,2,1,4,RENO72,1333,5/12/22
10230,1,4,1,6,SCARE13,1339,5/12/22
10231,0,5,4,9,HOOK65,1336,5/12/22
10232,0,2,2,4,BADGR03,1439,5/12/22
10233,2,2,1,5,AXLE11,1451,5/12/22
10234,2,2,5,9,AXLE12,1500,5/12/22
10235,2,2,2,6,RAGTAG1,1509,5/12/22
10236,2,2,1,5,RAGTAG3,1512,5/12/22
10237,2,2,0,4,RAGTAG4,1515,5/12/22
10238,0,2,0,2,HOOK02,1315,5/12/22
10239,3,3,0,6,BALL15,1503,5/12/22
10240,1,3,1,5,RECON87,1551,5/12/22
10241,1,4,1,6,SCARE64,1521,5/12/22
10242,1,2,2,5,BALL24,1524,5/12/22
10243,0,4,1,5,CRAZE16,1530,5/12/22
10244,1,4,1,6,BALL22,1527,5/12/22
10245,1,2,4,7,COBRA06,1542,5/12/22
10246,1,1,2,4,COBRA08,1539,5/12/22
10247,1,2,4,7,COBRA02,1548,5/12/22
10248,0,2,3,5,HOOK21,1500,5/12/22
10249,0,2,3,5,DRAGN06,1545,5/12/22
10250,2,3,2,7,RECON99,1554,5/12/22
10251,3,2,3,8,DRAGN01,1600,5/12/22
10252,1,4,2,7,COACH21,1612,5/12/22
10253,4,4,2,10,COACH22,1615,5/12/22
10254,1,4,3,8,DAWG02,1557,5/12/22
10255,5,2,1,8,BALL77,1603,5/12/22
10256,0,4,5,9,HOOK65,1024,5/13/22
10257,1,0,1,2,PAWS25,1030,5/13/22
10258,2,0,1,3,SMALL72,842,5/13/22
10259,1,0,1,2,HANG51,830,5/13/22
10260,1,0,2,3,HANG52,833,5/13/22
10261,1,4,4,9,PAWS44,836,5/13/22
10262,0,3,1,4,BALL16,854,5/13/22
10263,4,2,3,9,DRAGN59,851,5/13/22
10264,0,0,0,0,BADGR03,857,5/13/22
10265,1,2,1,4,BALL89,912,5/13/22
10266,0,2,2,4,RECON03,915,5/13/22
10267,0,2,2,4,DRAGN06,918,5/13/22
10268,1,0,3,4,DRAGN96,921,5/13/22
10269,4,0,0,4,SMALL22,942,5/13/22
10270,3,0,3,6,BALL24,936,5/13/22
10271,1,2,2,5,CRAZE16,948,5/13/22
10272,0,3,0,3,BALL22,939,5/13/22
10273,2,0,2,4,FURY01,945,5/13/22
10274,0,2,1,3,CRAZE42,957,5/13/22
10275,1,1,2,4,BALL04,951,5/13/22
10276,0,2,3,5,PAWS46,954,5/13/22
10277,1,2,4,7,AXLE11,1200,5/13/22
10278,3,2,0,5,AXLE12,1203,5/13/22
10279,0,2,6,8,SPECK02,1006,5/13/22
10280,1,3,3,7,CAOCH21,1009,5/13/22
10281,1,3,1,5,COACH22,1012,5/13/22
10282,2,2,0,4,GOLEM31,1112,5/13/22
10283,0,0,0,0,GOLEM,0,5/13/22
10284,1,2,2,5,GOLEM32,1115,5/13/22
10285,1,4,0,5,TAUNT21,1106,5/13/22
10286,1,4,1,6,TAUNT22,1109,5/13/22
10287,2,3,0,5,TORA31,1118,5/13/22
10288,0,0,1,1,TORA32,1121,5/13/22
10289,2,2,3,7,MANLY11,1124,5/13/22
10290,2,2,1,5,MANLY12,1127,5/13/22
10291,2,2,0,4,MANLY13,1130,5/13/22
10292,2,2,3,7,MANLY14,1133,5/13/22
10293,2,2,8,12,HOOK75,1027,5/13/22
10294,1,1,2,4,RENO71,1206,5/13/22
10295,1,1,3,5,RENO72,1206,5/13/22
10296,0,1,2,3,CRAZE47,1224,5/13/22
10297,2,2,4,8,DRAGN41,1215,5/13/22
10298,0,0,2,2,OUZO11,1157,5/13/22
10299,0,0,2,2,OUZO12,1157,5/13/22
10300,1,1,0,2,GIMZO31,1148,5/13/22
10301,1,1,6,8,GIZMO32,1148,5/13/22
10302,2,2,4,8,LOST31,1142,5/13/22
10303,2,2,3,7,LOST32,1145,5/13/22
10304,0,3,1,4,LOOT51,1200,5/13/22
10305,1,1,4,6,DRAGN42,1218,5/13/22
10306,0,1,3,4,CRAZE33,1236,5/13/22
10307,3,3,1,7,BALL13,1248,5/13/22
10308,1,3,1,5,STAB11,1242,5/13/22
10309,1,3,4,8,STAB12,1242,5/13/22
10310,0,5,3,8,BALL89,1251,5/13/22
10311,0,2,1,3,BALL23,1239,5/13/22
10312,2,0,0,2,HOOK61,1300,5/13/22
10313,1,0,3,4,TAUNT11,1136,5/13/22
10314,1,0,3,4,TAUNT12,1139,5/13/22
10315,1,0,2,3,BADGR69,1315,5/13/22
10316,0,0,2,2,HOOK22,1203,5/13/22
10317,1,4,1,6,LOOT69,1318,5/13/22
10318,0,2,1,3,BALL22,1312,5/13/22
10319,0,0,1,1,PHNTM77,1321,5/13/22
10320,2,0,2,4,DRAGN06,1309,5/13/22
10321,1,2,4,7,WIRE31,1415,5/13/22
10322,1,3,2,6,WIRE32,1415,5/13/22
10323,0,1,0,1,PAWS34,1257,5/13/22
10324,1,2,3,6,CRAZE46,1506,5/13/22
10325,1,2,1,4,COBRA02,1509,5/13/22
10326,1,2,2,5,COBRA05,1512,5/13/22
10327,1,0,1,2,RECON99,1521,5/13/22
10328,0,1,0,1,HOOK91,1300,5/13/22
10329,5,0,0,5,BALL42,1518,5/13/22
10330,3,2,3,8,BALL79,1524,5/13/22
10331,1,2,0,3,BALL14,1527,5/13/22
10332,1,2,3,6,HOOK71,1610,5/13/22
10333,1,0,1,2,SCARE21,939,5/16/22
10334,1,0,3,4,SCARE87,936,5/16/22
10335,2,2,1,5,HOOK44,933,5/16/22
10336,1,2,0,3,SCARE36,951,5/16/22
10337,1,1,0,2,DRAGN05,931,5/16/22
10338,1,3,2,6,AXLE11,942,5/16/22
10339,1,3,2,6,AXLE12,942,5/16/22
10340,1,2,1,4,SCARE76,1003,5/16/22
10341,1,4,2,7,SCARE18,954,5/16/22
10342,0,1,2,3,PHNTM77,1000,5/16/22
10343,0,4,4,8,FURY03,957,5/16/22
10344,1,3,1,5,CRAZE16,1006,5/16/22
10345,2,3,0,5,BALL72,1200,5/16/22
10346,0,4,1,5,BALL19,1100,5/16/22
10347,1,3,2,6,RECON01,1118,5/16/22
10348,0,1,3,4,BALL12,1057,5/16/22
10349,0,2,1,3,BALL16,1103,5/16/22
10350,0,4,1,5,RECON03,1057,5/16/22
10351,1,0,1,2,STAB11,1106,5/16/22
10352,1,0,4,5,STAB12,1109,5/16/22
10353,1,1,1,3,BALL79,1054,5/16/22
10354,1,2,2,5,COBRA02,1112,5/16/22
10355,2,0,2,4,COBRA06,1115,5/16/22
10356,1,0,1,2,VEGA21,1121,5/16/22
10357,1,0,1,2,VEGA22,1121,5/16/22
10358,3,0,3,6,CRAZE12,1127,5/16/22
10359,2,2,4,8,DRAGN48,1148,5/16/22
10360,1,2,1,4,RECON87,1130,5/16/22
10361,1,2,0,3,FILL31,1154,5/16/22
10362,1,2,3,6,FILL32,1157,5/16/22
10363,2,4,1,7,DRAGN42,1151,5/16/22
10364,0,2,5,7,HOOK03,1203,5/16/22
10365,1,2,0,3,TORA31,1233,5/16/22
10366,1,2,2,5,TORA32,1236,5/16/22
10367,0,3,2,5,DRAGN87,1245,5/16/22
10368,2,2,5,9,SPECK69,1239,5/16/22
10369,2,2,2,6,BALL65,1242,5/16/22
10370,2,4,3,9,HOOK71,1300,5/16/22
10371,1,4,1,6,WIRE31,1251,5/16/22
10372,1,4,1,6,WIRE32,1254,5/16/22
10373,2,1,2,5,DRAGN05,1306,5/16/22
10374,1,1,3,5,DRAGN33,1312,5/16/22
10375,1,2,2,5,RENO71,1248,5/16/22
10376,1,2,3,6,RENO72,1251,5/16/22
10377,1,2,1,4,HANG51,1318,5/16/22
10378,1,2,1,4,HANG52,1321,5/16/22
10379,3,3,0,6,SMALL35,1315,5/16/22
10380,4,4,4,12,DRAGN59,1309,5/16/22
10381,1,0,5,6,PHNTM55,1303,5/16/22
10382,1,0,1,2,CREEP31,1348,5/16/22
10383,1,0,1,2,CREEP32,1351,5/16/22
10384,0,2,1,3,DRAGN04,1345,5/16/22
10385,2,0,2,4,SHINR81,1354,5/16/22
10386,2,0,2,4,SHINR82,1357,5/16/22
10387,0,0,2,2,DRAGN41,1427,5/16/22
10388,0,0,1,1,DAWG01,1403,5/16/22
10389,2,3,5,10,SPECK02,1409,5/16/22
10390,2,2,2,6,BALL61,1406,5/16/22
10391,0,2,3,5,BALL29,1412,5/16/22
10392,1,0,2,3,AXLE11,1427,5/16/22
10393,0,2,0,2,BALL69,1415,5/16/22
10394,4,0,1,5,SMALL63,1421,5/16/22
10395,0,2,1,3,CRAZE48,1418,5/16/22
10396,0,2,1,3,BALL22,1424,5/16/22
10397,0,2,4,6,BALL12,1436,5/16/22
10398,0,2,3,5,FURY01,1406,5/16/22
10399,1,2,0,3,STAB11,1436,5/16/22
10400,1,2,0,3,STAB12,1436,5/16/22
10401,3,3,2,8,BALL01,1400,5/16/22
10402,2,2,4,8,DRAGN37,1445,5/16/22
10403,1,2,4,7,BALL18,1430,5/16/22
10404,0,1,2,3,DRAGN32,1442,5/16/22
10405,4,2,2,8,ETCH41,1545,5/16/22
10406,4,2,2,8,ETCH42,1548,5/16/22
10407,1,0,1,2,HANG51,1609,5/16/22
10408,4,0,0,4,HANG52,1612,5/16/22
10409,1,0,0,1,VEGA21,1603,5/16/22
10410,4,0,0,4,VEGA22,1603,5/16/22
10411,3,0,1,4,SMALL41,1627,5/16/22
10412,2,2,3,7,HOOK66,1557,5/16/22
10413,1,2,0,3,HOOK68,1600,5/16/22
10414,3,0,0,3,SMALL77,1624,5/16/22
10415,1,2,2,5,SCARE13,1618,5/16/22
10416,0,2,4,6,BALL16,1621,5/16/22
10417,0,2,3,5,PHNTM14,1615,5/16/22
10418,4,0,3,7,SMALL24,1630,5/16/22
10419,1,2,1,4,CRAZE34,1630,5/16/22
10420,1,2,2,5,COBRA02,1633,5/16/22
10421,1,2,1,4,DAWG02,1639,5/16/22
10422,1,2,4,7,CRAZE12,1645,5/16/22
10423,1,2,5,8,RECON87,1639,5/16/22
10424,0,2,2,4,BALL62,1642,5/16/22
10425,3,2,3,8,AXLE11,1718,5/16/22
10426,1,2,4,7,AXLE12,1718,5/16/22
10427,1,2,2,5,TAUNT21,1736,5/16/22
10428,1,2,2,5,TAUNT22,1739,5/16/22
10429,0,2,2,4,BALL59,1830,5/16/22
10430,2,2,2,6,BALL69,2154,5/16/22
10431,2,3,2,7,BALL29,2151,5/16/22
10432,1,3,5,9,DRAGN33,2045,5/16/22
10433,1,0,2,3,DRAGN91,2042,5/16/22
10434,1,0,2,3,DRAGN91,2042,5/16/22
10435,2,3,2,7,HOOK13,2103,5/16/22
10436,1,3,2,6,HOOK25,2054,5/16/22
10437,2,2,1,5,LOOT51,2048,5/16/22
10438,2,3,2,7,HOOK23,2100,5/16/22
10439,2,3,4,9,LOOT14,2057,5/16/22
10440,2,0,0,2,HOOK22,2051,5/16/22
10441,4,3,5,12,HOOK37,2139,5/16/22
10442,2,3,2,7,BALL77,2133,5/16/22
10443,2,2,4,8,BALL62,2130,5/16/22
10444,1,1,1,3,BALL56,2142,5/16/22
10445,4,2,1,7,HOOK36,2136,5/16/22
10446,1,3,2,6,LOOT48,2145,5/16/22
10447,2,3,3,8,Dragn01,930,5/17/22
10448,1,5,2,8,Dragn42,933,5/17/22
10449,1,3,2,6,CRAZE42,939,5/17/22
10450,0,3,5,8,DRAGN48,936,5/17/22
10451,1,5,2,8,HANG52,945,5/17/22
10452,1,3,3,7,SCARE14,951,5/17/22
10453,1,3,6,10,CREEP31,954,5/17/22
10454,1,4,1,6,DRAGN59,942,5/17/22
10455,1,4,1,6,AXLE11,1000,5/17/22
10456,0,6,0,6,HOOK44,1009,5/17/22
10457,1,3,1,5,SCARE18,1015,5/17/22
10458,1,2,2,5,COBRA06,1012,5/17/22
10459,1,4,1,6,HOOK72,1006,5/17/22
10460,0,5,1,6,DRAGN04,1018,5/17/22
10461,0,3,0,3,CRAZE76,1021,5/17/22
10462,2,2,4,8,BALL03,1027,5/17/22
10463,0,2,0,2,BADGR03,1024,5/17/22
10464,3,4,1,8,SMALL43,1033,5/17/22
10465,1,3,2,6,SPOT91,1036,5/17/22
10466,5,5,3,13,BALL41,1030,5/17/22
10467,0,4,5,9,DRAGN71,1042,5/17/22
10468,0,6,0,6,LOOT77,1045,5/17/22
10469,1,6,1,8,LOOT69,1048,5/17/22
10470,0,6,0,6,PAWS16,1051,5/17/22
10471,0,5,1,6,BADGR02,1100,5/17/22
10472,0,4,2,6,BALL04,1024,5/17/22
10473,1,3,3,7,BALL24,1057,5/17/22
10474,4,3,1,8,WIRE32,1142,5/17/22
10475,1,2,2,5,CRAZE12,1139,5/17/22
10476,0,5,1,6,PAWS76,1136,5/17/22
10477,0,5,1,6,BALL19,1130,5/17/22
10478,0,3,0,3,BALL15,1133,5/17/22
10479,2,5,1,8,SLOW31,1157,5/17/22
10480,2,3,0,5,GHOST69,1148,5/17/22
10481,2,2,1,5,SLOW51,1151,5/17/22
10482,2,5,0,7,PAWS44,1200,5/17/22
10483,0,4,0,4,CRAZE34,1233,5/17/22
10484,1,3,2,6,CRAZE48,1230,5/17/22
10485,1,4,1,6,HOOK69,1306,5/17/22
10486,1,2,0,3,PAWS14,1236,5/17/22
10487,2,3,0,5,DRAGN91,1254,5/17/22
10488,1,4,2,7,GOLEM32,1242,5/17/22
10489,0,2,3,5,BADGR03,1309,5/17/22
10490,1,4,3,8,STAB12,1300,5/17/22
10491,1,2,1,4,RECON99,1336,5/17/22
10492,1,2,2,5,RECON71,1339,5/17/22
10493,1,3,3,7,DRAGN42,1345,5/17/22
10494,2,3,4,9,DRAGN48,1342,5/17/22
10495,3,3,1,7,Small 65,1351,5/17/22
10496,2,3,1,6,CRAZE 88,1348,5/17/22
10497,1,3,3,7,CREEP 31,1409,5/17/22
10498,0,5,5,10,DRAGN 77,1357,5/17/22
10499,2,4,0,6,DRAGN 13,1354,5/17/22
10500,2,1,3,6,DRAGN 04,1418,5/17/22
10501,1,6,6,13,PAWS 42,1403,5/17/22
10502,3,3,1,7,BALL 77,1427,5/17/22
10503,0,3,4,7,DRAGN 37,1421,5/17/22
10504,4,4,3,11,VEGA 21,1430,5/17/22
10505,1,3,2,6,RECON 87,1424,5/17/22
10506,7,4,0,11,VEGA 22,1433,5/17/22
10507,4,3,2,9,CREEP 32,1412,5/17/22
10508,0,4,1,5,PAWS 16,1436,5/17/22
10509,1,4,3,8,RENO 71,1445,5/17/22
10510,1,4,1,6,RENO 72,1448,5/17/22
10511,1,4,1,6,CRAZE 34,1533,5/17/22
10512,1,3,3,7,CRAZE 48,1530,5/17/22
10513,1,4,2,7,TAUNT 21,1548,5/17/22
10514,1,4,2,7,TAUNT 22,1551,5/17/22
10515,1,4,2,7,DRAGN 23,1603,5/17/22
10516,0,4,0,4,DRAGN 25,1600,5/17/22
10517,1,4,2,7,HANG 51,1606,5/17/22
10518,3,4,0,7,HANG 52,1609,5/17/22
10519,1,5,1,7,COACH 21,1615,5/17/22
10520,1,5,1,7,COACH 22,1618,5/17/22
10521,1,3,3,7,CRAZE 12,1624,5/17/22
10522,0,3,4,7,PAWS 76,1621,5/17/22
10523,0,4,3,7,FURY 02,1633,5/17/22
10524,1,4,3,8,SHINR 81,1630,5/17/22
10525,1,4,1,6,SHINR 82,1633,5/17/22
10526,1,4,2,7,DAWG 04,1627,5/17/22
10527,0,4,1,5,BALL 42,1639,5/17/22
10528,3,4,2,9,PHNTM 55,1642,5/17/22
10529,4,3,3,10,HOOK66,2000,5/17/22
10530,1,4,3,8,DRAGN69,2036,5/17/22
10531,2,4,1,7,HOOK51,2039,5/17/22
10532,5,4,5,14,HOOK37,2057,5/17/22
10533,5,3,2,10,HOOK32,2100,5/17/22
10534,2,5,2,9,DRAGN23,2048,5/17/22
10535,2,3,4,9,HOOK22,2042,5/17/22
10536,1,4,4,9,GHOST02,2103,5/17/22
10537,2,3,1,6,HOOK13,2142,5/17/22
10538,1,2,0,3,DRAGN21,2054,5/17/22
10539,2,3,0,5,LOOT14,2051,5/17/22
10540,2,6,3,11,AMMO02,2133,5/17/22
10541,2,4,3,9,AMMO06,2136,5/17/22
10542,4,4,2,10,BALL18,2130,5/17/22
10543,5,1,1,7,LOOT48,2148,5/17/22
10544,2,3,4,9,DRAGN48,936,5/18/22
10545,0,6,1,7,CRAZE44,942,5/18/22
10546,1,2,4,7,DRAGN05,939,5/18/22
10547,1,5,0,6,PAWS76,1009,5/18/22
10548,3,2,2,7,SMALL26,954,5/18/22
10549,2,0,1,3,DRAGN04,1003,5/18/22
10550,1,0,3,4,WIRE31,1027,5/18/22
10551,0,6,4,10,CRAZE79,1006,5/18/22
10552,1,0,3,4,WIRE32,1030,5/18/22
10553,0,6,3,9,FURY01,1015,5/18/22
10554,0,4,1,5,BALL88,1021,5/18/22
10555,0,2,1,3,BADGR69,1033,5/18/22
10556,0,4,2,6,BALL04,1039,5/18/22
10557,0,5,1,6,BALL24,1042,5/18/22
10558,0,3,3,6,LOOT77,1036,5/18/22
10559,0,3,1,4,BALL29,1051,5/18/22
10560,0,2,0,2,COBRA02,1103,5/18/22
10561,0,2,0,2,CRAZE34,1100,5/18/22
10562,2,0,0,2,BALL72,1057,5/18/22
10563,0,0,0,0,CRAZE88,1054,5/18/22
10564,0,5,2,7,BALL22,1127,5/18/22
10565,0,2,1,3,LOOT69,1130,5/18/22
10566,1,1,3,5,BALL91,1145,5/18/22
10567,0,4,2,6,BALL41,1151,5/18/22
10568,1,1,3,5,BALL92,1148,5/18/22
10569,1,5,4,10,TORA51,1154,5/18/22
10570,1,5,3,9,TORA52,1157,5/18/22
10571,2,5,1,8,SLOW51,1236,5/18/22
10572,1,5,0,6,SLOW52,1242,5/18/22
10573,0,4,4,8,HOOK03,1203,5/18/22
10574,3,4,1,8,HOOK76,1200,5/18/22
10575,1,7,1,9,ETCH41,1245,5/18/22
10576,1,7,2,10,ETCH42,1248,5/18/22
10577,0,1,0,1,DRAGN25,1251,5/18/22
10578,3,5,3,11,DRAGN02,1315,5/18/22
10579,2,1,6,9,CRAZE88,1318,5/18/22
10580,1,3,2,6,AXLE11,1339,5/18/22
10581,1,4,2,7,HANG51,1333,5/18/22
10582,0,3,0,3,DRAGN41,1327,5/18/22
10583,4,4,0,8,DRAGN38,1354,5/18/22
10584,1,7,1,9,HOOK72,1330,5/18/22
10585,3,1,4,8,HYDRA41,1324,5/18/22
10586,3,0,0,3,SMALL06,1348,5/18/22
10587,3,4,0,7,SMALL47,1345,5/18/22
10588,2,3,0,5,shinr81,1403,5/18/22
10589,2,3,1,6,shinr82,1406,5/18/22
10590,2,1,2,5,dragn81,1400,5/18/22
10591,1,3,1,5,creep31,1409,5/18/22
10592,1,3,2,6,creep32,1412,5/18/22
10593,3,1,1,5,small88,1542,5/18/22
10594,1,3,1,5,SCARE64,1415,5/18/22
10595,1,3,0,4,DRAGN69,1418,5/18/22
10596,0,1,2,3,CRAZE79,1351,5/18/22
10597,0,2,2,4,BALL24,1421,5/18/22
10598,0,3,1,4,BALL29,1424,5/18/22
10599,1,3,4,8,COBRA06,1433,5/18/22
10600,1,1,1,3,COBRA05,1439,5/18/22
10601,1,1,3,5,RECON99,1436,5/18/22
10602,0,1,4,5,DRAGN32,1445,5/18/22
10603,1,1,3,5,COBRA02,1442,5/18/22
10604,0,3,3,6,PHNTM51,1448,5/18/22
10605,1,1,1,3,COBRA08,1530,5/18/22
10606,1,3,3,7,CRAZE12,1533,5/18/22
10607,3,3,0,6,BALL87,1548,5/18/22
10608,1,2,3,6,CRAZE48,1545,5/18/22
10609,0,3,0,3,PAWS16,1539,5/18/22
10610,1,1,4,6,DAWG04,1551,5/18/22
10611,1,1,2,4,STAB11,1600,5/18/22
10612,1,1,3,5,STAB12,1603,5/18/22
10613,2,3,0,5,HOOK61,1557,5/18/22
10614,4,1,3,8,DRAGN22,1606,5/18/22
10615,0,3,3,6,FURY02,1612,5/18/22
10616,1,1,1,3,RENO71,1615,5/18/22
10617,1,1,1,3,RENO72,1621,5/18/22
10618,1,1,4,6,AXLE11,1621,5/18/22
10619,3,1,2,6,AXLE12,1624,5/18/22
10620,2,3,0,5,COACH21,1627,5/18/22
10621,2,3,1,6,COACH22,1630,5/18/22
10622,1,1,2,4,SCARE42,1633,5/18/22
10623,1,3,2,6,SCARE565,1618,5/18/22
10624,1,3,2,6,SCARE45,1618,5/18/22
10625,4,3,0,7,DRAGN59,1715,5/18/22
10626,1,3,2,6,HANG51,1733,5/18/22
10627,1,3,1,5,HANG52,1736,5/18/22
10628,4,1,4,9,HOOK37,2130,5/18/22
10629,2,1,3,6,HOOK22,2045,5/18/22
10630,2,3,3,8,BALL77,2103,5/18/22
10631,1,0,4,5,LOOT14,2051,5/18/22
10632,1,1,1,3,DRAGN13,2057,5/18/22
10633,1,0,1,2,DRAGN13,2057,5/18/22
10634,2,3,2,7,BALL38,2054,5/18/22
10635,1,1,0,2,RECON03,2039,5/18/22
10636,2,2,2,6,HOOK23,2048,5/18/22
10637,2,1,1,4,LOOT48,2145,5/18/22
10638,2,1,1,4,HOOK21,2042,5/18/22
10639,2,2,0,4,BALL19,2142,5/18/22
10640,3,2,4,9,HOOK32,2318,5/18/22
10641,3,0,0,3,SMALL26,954,5/19/22
10642,0,2,0,2,DRAGN72,954,5/19/22
10643,0,1,2,3,HOOK69,1009,5/19/22
10644,2,0,3,5,DRAGN33,1021,5/19/22
10645,4,2,2,8,SMALL36,1018,5/19/22
10646,2,0,0,2,PAWS79,1012,5/19/22
10647,2,1,1,4,CREEP31,0,5/19/22
10648,1,1,1,3,CREEP32,1024,5/19/22
10649,0,2,0,2,DRAGN91,1015,5/19/22
10650,1,2,2,5,SCARE42,1024,5/19/22
10651,0,2,1,3,LOOT69,1106,5/19/22
10652,1,3,1,5,RENO71,1054,5/19/22
10653,1,3,4,8,RENO72,0,5/19/22
10654,2,0,1,3,HOOK21,1051,5/19/22
10655,1,2,2,5,BADGR04,1103,5/19/22
10656,4,2,1,7,SMALL57,1109,5/19/22
10657,2,2,2,6,STAB11,1121,5/19/22
10658,1,2,0,3,STAB12,1124,5/19/22
10659,1,1,0,2,BALL91,1115,5/19/22
10660,1,1,0,2,BALL92,1118,5/19/22
10661,4,4,2,10,COACH21,1100,5/19/22
10662,1,4,0,5,COACH22,1112,5/19/22
10663,0,4,2,6,HOOK13,1136,5/19/22
10664,1,4,3,8,CRAZE42,1142,5/19/22
10665,2,5,3,10,SLOW31,1157,5/19/22
10666,2,5,2,9,SLOW32,1200,5/19/22
10667,4,4,4,12,DRAGN53,1148,5/19/22
10668,2,4,2,8,PAWS33,1139,5/19/22
10669,3,3,3,9,HOOK68,1203,5/19/22
10670,1,3,2,6,TORA51,1215,5/19/22
10671,1,0,3,4,RECON03,1230,5/19/22
10672,5,2,2,9,PAWS48,1230,5/19/22
10673,2,3,3,8,SLOW21,1236,5/19/22
10674,2,2,1,5,GOLEM31,1251,5/19/22
10675,2,2,2,6,HANG51,1312,5/19/22
10676,2,2,2,6,HANG52,1315,5/19/22
10677,1,3,5,9,DRAGN48,1315,5/19/22
10678,1,4,1,6,SCARE44,1330,5/19/22
10679,0,4,4,8,DRAGN32,1327,5/19/22
10680,5,3,1,9,SMALL36,1318,5/19/22
10681,4,4,0,8,BALL69,1045,5/19/22
10682,3,1,0,4,SMALL57,1351,5/19/22
10683,1,1,1,3,SCARE99,1357,5/19/22
10684,4,1,2,7,SMALL40,1324,5/19/22
10685,0,2,2,4,DRAGN04,1400,5/19/22
10686,1,4,1,6,SHINR81,1403,5/19/22
10687,1,4,2,7,SHINR82,1406,5/19/22
10688,4,4,2,10,DRAGN52,1354,5/19/22
10689,1,3,3,7,BALL61,1412,5/19/22
10690,1,3,5,9,BALL81,1421,5/19/22
10691,1,3,1,5,BALL82,1424,5/19/22
10692,2,3,0,5,DRAGN51,1409,5/19/22
10693,4,4,0,8,HOOK61,1430,5/19/22
10694,3,2,0,5,SMALL67,1433,5/19/22
10695,4,4,4,12,DRAGN91,1427,5/19/22
10696,4,1,2,7,SMALL44,1636,5/19/22
10697,1,3,1,5,PAWS66,1436,5/19/22
10698,1,2,0,3,CREEP31,1600,5/19/22
10699,1,2,2,5,CREEP32,1603,5/19/22
10700,1,3,4,8,HOOK37,1624,5/19/22
10701,0,3,0,3,DRAGN25,1615,5/19/22
10702,1,4,2,7,BALL24,1627,5/19/22
10703,0,4,2,6,HOOK22,1621,5/19/22
10704,2,2,4,8,HOOK71,1618,5/19/22
10705,1,4,2,7,COBRA05,1642,5/19/22
10706,2,3,1,6,LOOT77,1633,5/19/22
10707,1,3,0,4,BALL22,1630,5/19/22
10708,1,4,2,7,COBRA02,1639,5/19/22
10709,1,3,1,5,RECON99,1651,5/19/22
10710,3,1,0,4,DAWG02,1706,5/19/22
10711,4,2,4,10,BALL44,1657,5/19/22
10712,1,2,5,8,DAWG04,1700,5/19/22
10713,1,2,0,3,TAUNT11,1709,5/19/22
10714,1,2,0,3,TAUNT12,1709,5/19/22
10715,1,2,2,5,RECON81,2048,5/19/22
10716,2,2,1,5,BALL77,2045,5/19/22
10717,2,2,3,7,AMMO06,2054,5/19/22
10718,2,2,1,5,BALL12,2057,5/19/22
10719,1,4,1,6,PHNTM51,2039,5/19/22
10720,1,4,1,6,COBRA08,2100,5/19/22
10721,2,4,2,8,COBRA08,2103,5/19/22
10722,2,1,2,5,BALL58,2100,5/19/22
10723,2,2,1,5,BALL56,2133,5/19/22
10724,1,1,1,3,AMMO04,2100,5/19/22
10725,1,1,3,5,DRAGN02,2042,5/19/22
10726,2,4,1,7,CRAZE88,836,5/20/22
10727,1,7,4,12,SCARE26,842,5/20/22
10728,2,5,5,12,PHNTM55,839,5/20/22
10729,0,5,3,8,HOOK71,851,5/20/22
10730,1,6,5,12,HANG51,854,5/20/22
10731,2,6,3,11,HANG52,857,5/20/22
10732,1,5,0,6,AXLE11,900,5/20/22
10733,1,5,1,7,AXLE12,903,5/20/22
10734,0,3,3,6,DRAGON42,912,5/20/22
10735,0,1,2,3,DRAGON23,918,5/20/22
10736,2,7,2,11,SLOW31,930,5/20/22
10737,1,7,3,11,SLOW32,933,5/20/22
10738,1,0,1,2,DRAGN44,833,5/20/22
10739,3,3,0,6,SMALL21,939,5/20/22
10740,3,3,0,6,SMALL11,915,5/20/22
10741,2,8,4,14,SLOW61,948,5/20/22
10742,1,8,0,9,SLOW62,951,5/20/22
10743,0,3,2,5,CRAZE48,1024,5/20/22
10744,0,4,1,5,BALL24,1027,5/20/22
10745,3,0,1,4,SMALL43,1033,5/20/22
10746,1,7,2,10,LOOT69,1030,5/20/22
10747,1,1,0,2,RENO71,942,5/20/22
10748,1,1,0,2,RENO72,1048,5/20/22
10749,1,0,0,1,ETCH41,1054,5/20/22
10750,1,0,3,4,ETCH42,1057,5/20/22
10751,0,0,0,0,HOOK12,1051,5/20/22
10752,2,4,2,8,TORA71,1100,5/20/22
10753,3,4,2,9,TORA72,1100,5/20/22
10754,2,5,1,8,SLOW51,1130,5/20/22
10755,1,2,0,3,SLOW51,1130,5/20/22
10756,1,7,1,9,LOST81,1124,5/20/22
10757,1,7,0,8,LOST82,1124,5/20/22
10758,2,2,3,7,DRAGN05,1239,5/20/22
10759,2,2,2,6,DRAGN01,1236,5/20/22
10760,1,5,1,7,TORA21,1230,5/20/22
10761,1,5,1,7,TORA22,1230,5/20/22
10762,2,2,5,9,DRAGN33,1242,5/20/22
10763,1,2,2,5,DRAGN41,1245,5/20/22
10764,2,4,2,8,PHNTM51,1233,5/20/22
10765,3,7,4,14,SLOW61,1240,5/20/22
10766,2,7,0,9,SLOW62,1240,5/20/22
10767,1,4,1,6,HANG51,1300,5/20/22
10768,4,4,5,13,HANG52,1300,5/20/22
10769,1,1,3,5,DRAGN23,1312,5/20/22
10770,1,1,2,4,AXLE11,1309,5/20/22
10771,4,1,1,6,AXLE12,1309,5/20/22
10772,4,5,2,11,SHINR81,1315,5/20/22
10773,1,5,0,6,SHINR82,1315,5/20/22
10774,1,0,3,4,PHNTM55,1321,5/20/22
10775,1,2,4,7,DRAGN48,1324,5/20/22
10776,3,3,1,7,DRAGN44,1348,5/20/22
10777,1,1,0,2,EASY86,1335,5/20/22
10778,3,1,4,8,TORA81,1257,5/20/22
10779,0,3,0,3,PAWS42,1342,5/20/22
10780,1,3,4,8,HOOK37,1339,5/20/22
10781,2,3,2,7,LOST11,1330,5/20/22
10782,2,3,4,9,LOST12,1330,5/20/22
10783,0,0,1,1,HOOK21,1336,5/20/22
10784,2,5,0,7,SLOW61,1457,5/20/22
10785,1,5,1,7,SLOW62,1457,5/20/22
10786,1,5,3,9,HANG51,1451,5/20/22
10787,1,5,1,7,HANG52,1454,5/20/22
10788,0,2,5,7,BADGR04,1503,5/20/22
10789,1,5,1,7,SCARE77,1509,5/20/22
10790,0,1,4,5,LOOT69,1506,5/20/22
10791,1,5,5,11,BALL99,1515,5/20/22
10792,1,3,2,6,CRAZE46,1524,5/20/22
10793,1,0,2,3,AMMO06,1518,5/20/22
10794,3,2,0,5,SMALL17,1533,5/20/22
10795,1,3,3,7,COBRA06,1527,5/20/22
10796,1,3,0,4,COBRA02,1530,5/20/22
10797,1,1,4,6,DAWG02,1536,5/20/22
10798,4,2,1,7,SMALL13,1521,5/20/22
10799,2,2,5,9,DRAGN52,1654,5/20/22
10800,0,1,6,7,HOOK33,1605,5/20/22
10801,0,0,0,0,BALL38,1539,5/20/22
10802,1,2,4,7,HOOK32,1557,5/20/22
10803,1,3,1,5,LOOT77,1609,5/20/22
10804,3,2,3,8,BALL79,1627,5/20/22
10805,0,0,0,0,PAWS77,1545,5/20/22
10806,0,0,7,7,HOOH48,1606,5/20/22
10807,1,1,0,2,HOOK04,1554,5/20/22
10808,0,3,0,3,BALL11,1624,5/20/22
10809,0,3,3,6,BALL12,1624,5/20/22
10810,0,3,0,3,BALL69,1612,5/20/22
10811,0,3,1,4,HOOK41,1600,5/20/22
10812,2,3,0,5,BALL64,1615,5/20/22
10813,2,2,5,9,BALL22,1618,5/20/22
10814,1,4,5,10,dragn59,830,5/23/22
10815,0,4,3,7,Hook72,821,5/23/22
10816,0,7,4,11,dragn99,824,5/23/22
10817,1,2,6,9,Creep31,806,5/23/22
10818,0,2,6,8,Paws77,812,5/23/22
10819,0,4,1,5,rhino99,800,5/23/22
10820,0,3,6,9,Hook61,816,5/23/22
10821,3,5,4,12,Hook01,803,5/23/22
10822,1,6,6,13,Reno71/72,833,5/23/22
10823,0,2,4,6,Hook71,818,5/23/22
10824,0,2,4,6,Dragn23,839,5/23/22
10825,1,3,4,8,Stab11/12,845,5/23/22
10826,1,6,0,7,Easy86,840,5/23/22
10827,0,1,7,8,Dragn31,842,5/23/22
10828,1,2,1,4,dragn91,909,5/23/22
10829,2,1,3,6,dragn52,851,5/23/22
10830,1,5,2,8,recon81,912,5/23/22
10831,0,2,2,4,Ball88,915,5/23/22
10832,2,3,0,5,dragn53,854,5/23/22
10833,0,2,1,3,dragn81,900,5/23/22
10834,2,0,2,4,small14,924,5/23/22
10835,1,3,1,5,craze44,1006,5/23/22
10836,2,3,0,5,dragn59,857,5/23/22
10837,1,0,3,4,dragn41,930,5/23/22
10838,0,5,0,5,cobra05,939,5/23/22
10839,5,0,1,6,small20,936,5/23/22
10840,1,5,3,9,cobra08,936,5/23/22
10841,0,1,4,5,dragn05,927,5/23/22
10842,2,6,2,10,phntm55,933,5/23/22
10843,0,4,2,6,CRAZE15,1457,5/24/22
10844,1,6,4,11,HOOK91,1448,5/24/22
10845,1,3,4,8,PAWS66,1651,5/24/22
10846,0,3,2,5,DRAGN04,1515,5/24/22
10847,1,4,3,8,HOOK44,1545,5/24/22
10848,0,5,2,7,FURY04,1524,5/24/22
10849,1,6,10,17,DRAGN21,1548,5/24/22
10850,1,4,2,7,LOOT14,1615,5/24/22
10851,1,4,5,10,HOOK31,1600,5/24/22
10852,0,5,8,13,BUBO32,1000,5/25/22
10853,1,2,7,10,DRAGN37,1054,5/25/22
10854,0,1,0,1,HOOK61,1139,5/25/22
10855,1,3,1,5,DRAGN91,930,5/26/22
10856,0,0,0,0,DRAGON05,0,5/26/22
10857,1,4,0,5,DROAGON05,933,5/26/22
10858,0,4,3,7,Dragon11,936,5/26/22
10859,0,5,0,5,RHINO99,800,5/26/22
10860,2,4,1,7,CREEP31,918,5/26/22
10861,0,4,4,8,RECON08,915,5/26/22
10862,0,7,0,7,Ball88,927,5/26/22
10863,0,4,4,8,Creep 32,921,5/26/22
10864,0,8,2,10,HOOK69,951,5/26/22
10865,2,7,1,10,HOOK62,945,5/26/22
10866,1,3,2,6,RECON81,924,5/26/22
10867,2,5,2,9,STABIV12,951,5/26/22
10868,3,5,5,13,STABIV13,954,5/26/22
10869,0,7,2,9,HOOK18,1006,5/26/22
10870,0,7,3,10,HOOK 76,1000,5/26/22
10871,1,1,4,6,DRAGON 02,1009,5/26/22
10872,2,6,5,13,HOOK 77,1003,5/26/22
10873,0,7,0,7,CRAZE66,948,5/26/22
10874,1,3,2,6,ETCH41,1018,5/26/22
10875,1,3,4,8,ETCH42,1021,5/26/22
10876,1,3,8,12,VEGA 21,1012,5/26/22
10877,1,3,2,6,VEGA 22,1015,5/26/22
10878,1,5,2,8,WIRE 31,1030,5/26/22
10879,1,5,4,10,Wire32,1033,5/26/22
10880,2,5,8,15,SPOT91,1024,5/26/22
10881,2,5,8,15,SPOT 92,1027,5/26/22
10882,0,3,2,5,PHNTM03,1036,5/26/22
10883,1,3,0,4,EASY86,1025,5/26/22
10884,2,9,3,14,GOLEM61,1048,5/26/22
10885,1,9,1,11,GOLEM62,1051,5/26/22
10886,1,7,3,11,TORA71,1054,5/26/22
10887,2,7,3,12,TORA72,1057,5/26/22
10888,1,5,3,9,EVIL 13,1042,5/26/22
10889,1,1,6,8,HOOK37,1045,5/26/22
10890,2,3,2,7,LOOT 14,1127,5/26/22
10891,1,3,1,5,Dragn 59,1142,5/26/22
10892,2,3,1,6,Dragn 51,1030,5/26/22
10893,1,1,2,4,HOOK 99,1124,5/26/22
10894,2,5,2,9,Dragn 81,1151,5/26/22
10895,1,3,4,8,Dragn 93,1136,5/26/22
10896,2,3,5,10,Dragn 52,1133,5/26/22
10897,0,3,2,5,PAWS33,1130,5/26/22
10898,2,2,0,4,Ragtag 1,1118,5/26/22
10899,2,2,0,4,ragtag 2,1118,5/26/22
10900,1,3,5,9,Dragn 48,1148,5/26/22
10901,0,1,2,3,Dragn 41,1151,5/26/22
10902,0,3,1,4,Craze88,1200,5/26/22
10903,1,3,3,7,Cobra 02,1206,5/26/22
10904,0,1,4,5,Dragn06,1154,5/26/22
10905,2,2,2,6,Phantm 55,1157,5/26/22
10906,0,3,6,9,Dragn 33,1203,5/26/22
10907,1,0,6,7,Cobra01,1209,5/26/22
10908,2,2,1,5,Evil18,1221,5/26/22
10909,3,1,3,7,Dawg04,1224,5/26/22
10910,1,1,7,9,Recon99,1218,5/26/22
10911,1,3,6,10,Dawg01,1227,5/26/22
10912,2,7,2,11,Post 61,1212,5/26/22
10913,1,7,3,11,Post 62,1215,5/26/22
10914,0,3,4,7,Cobra 05,1236,5/26/22
10915,2,7,3,12,Shinr81,1230,5/26/22
10916,2,7,5,14,shinr 82,1233,5/26/22
10917,4,4,3,11,dragn68,1239,5/26/22
10918,1,7,2,10,Axle 11,1242,5/26/22
10919,1,7,3,11,axle12,1245,5/26/22
10920,1,3,2,6,vega 21,1254,5/26/22
10921,1,3,2,6,vega 22,1257,5/26/22
10922,1,3,1,5,easy81,1301,5/26/22
10923,1,3,1,5,coach21,1248,5/26/22
10924,1,3,1,5,coach 22,1251,5/26/22
10925,0,4,4,8,Craze16,1306,5/26/22
10926,0,3,1,4,Ball88,1348,5/26/22
10927,1,3,1,5,Reno 71,1300,5/26/22
10928,1,3,1,5,reno72,1303,5/26/22
10929,2,3,1,6,creed31,1312,5/26/22
10930,2,3,2,7,creed32,1315,5/26/22
10931,0,5,5,10,ball 29,1309,5/26/22
10932,1,5,2,8,recon 01,1301,5/26/22
10933,1,5,4,10,hydra11,1318,5/26/22
10934,4,5,0,9,hydra12,1321,5/26/22
10935,2,7,1,10,wire31,1324,5/26/22
10936,1,7,4,12,wire32,1327,5/26/22
10937,1,5,3,9,dragn68,1330,5/26/22
10938,0,7,2,9,hook72,1333,5/26/22
10939,1,7,2,10,hang51,1336,5/26/22
10940,2,7,3,12,hang52,1339,5/26/22
10941,1,4,4,9,dragn42,1347,5/26/22
10942,0,3,4,7,recon82,1351,5/26/22
10943,3,5,1,9,dragn44,1345,5/26/22
10944,2,3,2,7,hook18,1442,5/26/22
10945,3,2,1,6,small73,1445,5/26/22
10946,2,1,4,7,etch41,1448,5/26/22
10947,2,1,6,9,etch41,1448,5/26/22
10948,1,1,5,7,reno71,0,5/26/22
10949,1,1,3,5,reno72,1457,5/26/22
10950,2,3,1,6,ghost69,1500,5/26/22
10951,1,3,8,12,hook21,1503,5/26/22
10952,1,3,8,12,spot91,1506,5/26/22
10953,1,3,8,12,spot92,1506,5/26/22
10954,1,1,6,8,wire31,1512,5/26/22
10955,1,1,5,7,wire32,1515,5/26/22
10956,0,5,5,10,loot14,1518,5/26/22
10957,2,3,6,11,DRAGN33,1527,5/26/22
10958,1,3,4,8,RECON99,1521,5/26/22
10959,1,3,3,7,phntm55,1530,5/26/22
10960,1,0,3,4,craze88,1533,5/26/22
10961,4,1,3,8,evil18,1524,5/26/22
10962,2,3,6,11,dragn48,1539,5/26/22
10963,2,3,2,7,phntm33,1542,5/26/22
10964,5,2,2,9,small20,1536,5/26/22
10965,1,6,5,12,POST61,824,5/31/22
10966,1,6,5,12,POST62,827,5/31/22
10967,0,1,1,2,ETCH41,809,5/31/22
10968,0,1,1,2,ETCH42,815,5/31/22
10969,0,5,3,8,SPECK02,836,5/31/22
10970,0,1,2,3,DRAGN13,803,5/31/22
10971,1,3,4,8,AXLE11,818,5/31/22
10972,1,3,3,7,AXLE12,821,5/31/22
10973,1,3,3,7,WIRE31,830,5/31/22
10974,1,3,4,8,WIRE32,833,5/31/22
10975,2,4,2,8,FURY03,839,5/31/22
10976,1,3,5,9,SHINR81,845,5/31/22
10977,1,3,2,6,SHINR82,848,5/31/22
10978,2,3,1,6,FURY01,842,5/31/22
10979,2,5,3,10,VEGA21,857,5/31/22
10980,2,5,5,12,VEGA22,900,5/31/22
10981,2,3,2,7,RECON81,912,5/31/22
10982,1,1,2,4,COACH21,851,5/31/22
10983,1,1,1,3,COACH22,854,5/31/22
10984,0,2,4,6,AMMO01,909,5/31/22
10985,0,1,2,3,HOOK31,906,5/31/22
10986,0,3,3,6,HOOK01,918,5/31/22
10987,1,1,2,4,DRAGN02,921,5/31/22
10988,1,5,0,6,CREEP31,924,5/31/22
10989,1,5,2,8,CREEP32,927,5/31/22
10990,1,1,0,2,HANG51,930,5/31/22
10991,1,1,0,2,HANG52,933,5/31/22
10992,4,3,3,10,DRAGN51,942,5/31/22
10993,2,3,0,5,DRAGN91,939,5/31/22
10994,4,3,4,11,DRAGN52,948,5/31/22
10995,1,2,3,6,DRAGN81,954,5/31/22
10996,4,3,2,9,CRAZE42,951,5/31/22
10997,1,3,2,6,DRAGN41,1003,5/31/22
10998,2,3,3,8,DRAGN52,951,5/31/22
10999,4,1,0,5,CRAZE88,1009,5/31/22
11000,1,3,4,8,DRAGN48,1000,5/31/22
11001,0,1,0,1,DRAGN05,957,5/31/22
11002,1,3,0,4,SCARE44,1018,5/31/22
11003,1,7,5,13,STAB11,1012,5/31/22
11004,1,7,4,12,STAB12,1015,5/31/22
11005,2,1,2,5,DRAGN19,1030,5/31/22
11006,0,5,2,7,HOOK23,1021,5/31/22
11007,2,3,1,6,RENO71,1024,5/31/22
11008,2,3,5,10,RENO72,1027,5/31/22
11009,0,3,5,8,DRAGN06,1033,5/31/22
11010,1,3,5,9,GIZMO21,1048,5/31/22
11011,1,3,1,5,GIZMO22,1051,5/31/22
11012,2,7,0,9,PAWS44,1057,5/31/22
11013,1,8,4,13,HOOK71,1133,5/31/22
11014,1,5,4,10,PAWS47,1130,5/31/22
11015,1,4,0,5,VEGA21,1136,5/31/22
11016,1,4,3,8,VEGA22,1136,5/31/22
11017,1,3,5,9,RECON99,1200,5/31/22
11018,2,5,2,9,WIRE31,1215,5/31/22
11019,1,5,5,11,WIRE31,1215,5/31/22
11020,1,2,1,4,EVIL18,1151,5/31/22
11021,1,3,3,7,COBRA01,1206,5/31/22
11022,2,4,5,11,PHNTM50,1148,5/31/22
11023,0,1,6,7,DAWG01,1157,5/31/22
11024,1,3,1,5,OOZU11,1118,5/31/22
11025,1,3,4,8,OUZO12,1121,5/31/22
11026,1,1,3,5,BALL85,1206,5/31/22
11027,1,5,2,8,TORA71,1103,5/31/22
11028,1,5,1,7,TORA72,1109,5/31/22
11029,0,7,3,10,TORA51,1245,5/31/22
11030,2,3,2,7,TORA52,1245,5/31/22
11031,0,3,5,8,HOOK37,1330,5/31/22
11032,1,3,4,8,TAUNT21,1330,5/31/22
11033,1,3,2,6,TAUNT22,1330,5/31/22
11034,0,2,2,4,BALL81,1345,5/31/22
11035,1,1,3,5,BALL22,1345,5/31/22
11036,0,2,2,4,BALL11,1321,5/31/22
11037,2,3,1,6,FILL31,1242,5/31/22
11038,2,3,1,6,FILL32,1245,5/31/22
11039,0,4,6,10,LOST31,1345,5/31/22
11040,1,2,5,8,BUBO32,1248,5/31/22
11041,2,0,3,5,BALL23,1327,5/31/22
11042,2,1,2,5,BALL42,1330,5/31/22
11043,0,3,1,4,MANLY12,1351,5/31/22
11044,1,5,1,7,TORA61,1400,5/31/22
11045,1,5,4,10,TORA62,1403,5/31/22
11046,0,2,3,5,LOOT33,1251,5/31/22
11047,2,0,2,4,dragn18,803,6/2/22
11048,2,1,6,9,dragn53,806,6/2/22
11049,0,0,5,5,dragn48,8210,6/2/22
11050,2,0,3,5,craze42,8150,6/2/22
11051,0,0,8,8,dragn33,824,6/2/22
11052,1,0,2,3,dragn81,812,6/2/22
11053,0,2,3,5,dragn06,818,6/2/22
11054,2,3,2,7,hook61,827,6/2/22
11055,1,0,3,4,wire31,833,6/2/22
11056,1,0,4,5,wire 32,835,6/2/22
11057,0,0,5,5,dragn31,1830,6/2/22
11058,3,1,3,7,hook99,842,6/2/22
11059,3,1,0,4,RHINO 99,800,6/2/22
11060,3,1,3,7,RHINO 99,845,6/2/22
11061,1,1,3,5,HANG 51,845,6/2/22
11062,1,3,1,5,HANG 52,8470,6/2/22
11063,1,2,5,8,HOOK 55,851,6/2/22
11064,2,1,4,7,VEGA21,827,6/2/22
11065,1,1,2,4,VEGA22,829,6/2/22
11066,1,0,3,4,RECON82,909,6/2/22
11067,0,0,2,2,LOOT 06,906,6/2/22
11068,0,0,6,6,CRAZE88,903,6/2/22
11069,2,3,2,7,HOOK02,915,6/2/22
11070,1,1,6,8,PHNTM50,921,6/2/22
11071,3,1,5,9,DAWG01,924,6/2/22
11072,0,0,3,3,DAWG09,927,6/2/22
11073,0,1,4,5,EVIL18,930,6/2/22
11074,1,2,0,3,SLOW51,939,6/2/22
11075,1,2,3,6,SLOW52,942,6/2/22
11076,0,2,5,7,LOST81,951,6/2/22
11077,0,1,6,7,BALL58,945,6/2/22
11078,0,3,3,6,LOST82,948,6/2/22
11079,0,3,3,6,AMMO09,1115,6/2/22
11080,1,1,2,4,COACH 21,1109,6/2/22
11081,1,1,0,2,COACH 22,1112,6/2/22
11082,3,1,2,6,HOOK44,1106,6/2/22
11083,1,1,3,5,RECON99,1118,6/2/22
11084,1,2,2,5,COBRA06,1121,6/2/22
11085,1,3,2,6,SHINR81,1130,6/2/22
11086,1,3,0,4,SHINR82,1133,6/2/22
11087,1,4,3,8,OUZO,1124,6/2/22
11088,2,1,4,7,DRAGN18,1206,6/2/22
11089,0,0,4,4,BADGR01,1136,6/2/22
11090,2,0,2,4,SMALL76,1154,6/2/22
11091,1,1,3,5,VEGA21,1142,6/2/22
11092,1,3,2,6,RENO71,1148,6/2/22
11093,1,1,8,10,DRAGN53,1203,6/2/22
11094,5,0,2,7,SMALL10,1212,6/2/22
11095,1,1,10,12,DRAGN,1157,6/2/22
11096,3,1,2,6,DRAGN,1209,6/2/22
11097,0,1,6,7,DRAGN06,1200,6/2/22
11098,1,1,6,8,AXLE11,1215,6/2/22
11099,1,3,1,5,BALL01,1230,6/2/22
11100,1,0,2,3,EASY42,1201,6/2/22
11101,0,1,2,3,HOOK01,1227,6/2/22
11102,0,1,7,8,PHNTM14,1221,6/2/22
11103,1,1,2,4,BALL88,1233,6/2/22
11104,0,1,6,7,LOOT45,1406,6/2/22
11105,1,1,4,6,VEGA21,1445,6/2/22
11106,1,2,0,3,CRAZE34,1500,6/2/22
11107,0,5,5,10,DRAGN55,1442,6/2/22
11108,1,2,4,7,RECON99,1457,6/2/22
11109,1,4,8,13,HANG51,1436,6/2/22
11110,0,2,4,6,DAWG01,1451,6/2/22
11111,0,1,5,6,DAWG09,1454,6/2/22
11112,2,1,0,3,FURY01,1503,6/2/22
11113,2,4,4,10,STAB11,1515,6/2/22
11114,0,4,3,7,RECON08,1512,6/2/22
11115,0,2,3,5,AMMO04,1506,6/2/22
11116,2,3,1,6,COACH21,1533,6/2/22
11117,0,2,2,4,PHNTM48,1509,6/2/22
11118,0,3,2,5,AMMO09,1530,6/2/22
11119,2,5,5,12,CREEP31,1524,6/2/22
11120,0,5,4,9,BALL64,1521,6/2/22
11121,2,1,4,7,GOLEM21,1709,6/2/22
11122,1,1,3,5,GOLEM22,1712,6/2/22
11123,1,1,3,5,Axle 11,800,6/3/22
11124,1,1,4,6,Axle 12,800,6/3/22
11125,0,0,4,4,Dawg01,806,6/3/22
11126,2,1,7,10,Phntm50,809,6/3/22
11127,1,1,5,7,STAB 11,812,6/3/22
11128,1,1,3,5,STAB 12,815,6/3/22
11129,1,1,5,7,COBRA 06,818,6/3/22
11130,4,0,1,5,SMALL99,824,6/3/22
11131,1,1,5,7,COBRA01,821,6/3/22
11132,0,1,4,5,RECON99,827,6/3/22
11133,0,1,3,4,CRAZE46,830,6/3/22
11134,0,0,3,3,BADGR01,839,6/3/22
11135,1,0,3,4,SHINR81,833,6/3/22
11136,4,0,1,5,SHINR82,836,6/3/22
11137,1,2,1,4,RENO71,845,6/3/22
11138,4,2,0,6,RENO72,848,6/3/22
11139,0,1,5,6,AMMO08,851,6/3/22
11140,1,1,2,4,DRAGN81,857,6/3/22
11141,2,0,2,4,DRAGN51,854,6/3/22
11142,2,1,2,5,BALL23,842,6/3/22
11143,2,1,0,3,RECON88,906,6/3/22
11144,1,1,6,8,DRAGON53,900,6/3/22
11145,1,0,1,2,WIRE31,912,6/3/22
11146,1,0,1,2,WIRE32,915,6/3/22
11147,0,0,3,3,RECON82,909,6/3/22
11148,3,0,3,6,DRAGN52,903,6/3/22
11149,0,2,3,5,PHNTM33,918,6/3/22
11150,3,0,3,6,DRAGN33,903,6/3/22
11151,0,0,4,4,BUBO32,936,6/3/22
11152,0,3,1,4,CRAZE88,945,6/3/22
11153,1,3,4,8,DRAGN48,939,6/3/22
11154,2,1,5,8,DRAGN06,942,6/3/22
11155,2,3,4,9,DAWG09,957,6/3/22
11156,1,2,4,7,DAWG02,1000,6/3/22
11157,1,3,1,5,CREEP31,1003,6/3/22
11158,2,3,3,8,CREEP32,1003,6/3/22
11159,3,0,0,3,SMALL33,1009,6/3/22
11160,2,2,2,6,HANG51,1012,6/3/22
11161,1,2,1,4,HANG52,1015,6/3/22
11162,4,1,1,6,DRAGN55,1018,6/3/22
11163,1,2,0,3,DRAGN61,1036,6/3/22
11164,1,2,1,4,VEGA21,1039,6/3/22
11165,1,2,2,5,VEGA22,1042,6/3/22
11166,0,1,2,3,PAWS66,1103,6/3/22
11167,0,1,5,6,HOOK03,1100,6/3/22
11168,2,3,5,10,HOOK37,1136,6/3/22
11169,1,1,1,3,AXLE11,1118,6/3/22
11170,2,1,1,4,AXLE12,1121,6/3/22
11171,1,1,4,6,GOLEM61,1154,6/3/22
11172,1,1,1,3,GOLEM62,1157,6/3/22
11173,0,3,1,4,AMMO01,1209,6/3/22
11174,1,3,6,10,HOOK34,1203,6/3/22
11175,0,1,5,6,DRAGN31,1200,6/3/22
11176,1,3,2,6,CRAZE34,1215,6/3/22
11177,1,3,5,9,HOOK04,1206,6/3/22
11178,1,3,5,9,COBRA05,1221,6/3/22
11179,0,1,6,7,PHNTM50,1212,6/3/22
11180,1,3,4,8,POST61,1215,6/3/22
11181,1,3,3,7,POST62,1148,6/3/22
11182,1,3,7,11,RECON99,1224,6/3/22
11183,1,3,3,7,WIRE31,1227,6/3/22
11184,1,3,3,7,WIRE32,1230,6/3/22
11185,0,1,4,5,CRAZE46,1251,6/3/22
11186,3,1,2,6,PAWS01,1236,6/3/22
11187,1,1,2,4,PAWS02,1145,6/3/22
11188,0,0,8,8,BADGER01,1245,6/3/22
11189,2,3,3,8,HOOK44,1254,6/3/22
11190,3,1,1,5,BALL22,1248,6/3/22
11191,1,1,1,3,RECON81,1257,6/3/22
11192,2,3,1,6,RECON88,1300,6/3/22
11193,1,3,2,6,CREEP31,1303,6/3/22
11194,1,3,2,6,CREEP32,1306,6/3/22
11195,2,2,4,8,DRAGN51,1318,6/3/22
11196,2,1,3,6,HOOK32,1309,6/3/22
11197,1,0,1,2,DRAGN59,1324,6/3/22
11198,4,2,2,8,SMALL41,1327,6/3/22
11199,1,2,5,8,DRAGN42,1333,6/3/22
11200,1,2,5,8,DRAGN33,1321,6/3/22
11201,3,2,2,7,SMALL46,1342,6/3/22
11202,3,2,2,7,SMALL42,1330,6/3/22
11203,3,3,1,7,SMALL45,1339,6/3/22
11204,1,2,6,9,DRAGN06,1336,6/3/22
11205,1,2,6,9,DAWG02,1409,6/3/22
11206,2,0,6,8,AMMO08,1133,6/3/22
11207,0,2,2,4,PHNTM14,1412,6/3/22
11208,2,3,5,10,RECON85,1406,6/3/22
11209,2,2,2,6,HOOK22,1415,6/3/22
11210,2,3,0,5,HOOK99,1139,6/3/22
11211,2,1,3,6,HOOK21,1142,6/3/22
11212,1,2,2,5,STAB11,1509,6/3/22
11213,4,2,2,8,STAB12,1512,6/3/22
11214,0,2,3,5,DRAGN05,1506,6/3/22
11215,1,2,0,3,HANG51,1524,6/3/22
11216,4,2,1,7,HANG52,1527,6/3/22
11217,0,3,3,6,HOOK81,1515,6/3/22
11218,1,3,3,7,RENO71,1500,6/3/22
11219,2,3,5,10,RENO72,1503,6/3/22
11220,2,4,4,10,WIRE31,1530,6/3/22
11221,2,4,3,9,WIRE32,1533,6/3/22
11222,1,3,2,6,SHINR81,1518,6/3/22
11223,1,3,5,9,SHINR82,1521,6/3/22
11224,0,1,3,4,GOLEM22,1600,6/3/22
11225,1,3,4,8,HOOK71,1151,6/3/22
11226,2,3,1,6,BALL08,1124,6/3/22
11227,2,3,0,5,BALL64,1127,6/3/22
11228,2,1,1,4,FURY02,933,6/6/22
11229,0,2,2,4,GHOST69,936,6/6/22
11230,1,1,3,5,COBRA05,942,6/6/22
11231,1,0,2,3,COBRA08,939,6/6/22
11232,3,2,0,5,SMALL25,951,6/6/22
11233,3,2,1,6,BALL42,945,6/6/22
11234,1,3,3,7,RECON85,948,6/6/22
11235,0,1,0,1,RHINO99,930,6/6/22
11236,3,2,0,5,SMALL30,1000,6/6/22
11237,0,2,7,9,CRAZE13,954,6/6/22
11238,0,0,1,1,DRAGN31,1003,6/6/22
11239,1,2,0,3,EVIL13,1006,6/6/22
11240,1,1,1,3,LOOT14,1009,6/6/22
11241,3,3,0,6,SMALL36,1018,6/6/22
11242,1,2,1,4,RENO71,1012,6/6/22
11243,1,2,3,6,RENO72,1012,6/6/22
11244,1,3,3,7,RECON82,1024,6/6/22
11245,1,2,0,3,EASY89,957,6/6/22
11246,0,1,2,3,HOOK02,1030,6/6/22
11247,1,1,3,5,RECON01,1027,6/6/22
11248,1,3,3,7,DRAGN19,1033,6/6/22
11249,1,3,3,7,WIRE01,1036,6/6/22
11250,1,3,0,4,WIRE02,1036,6/6/22
11251,1,1,0,2,AXLE11,1042,6/6/22
11252,1,1,0,2,AXLE12,1042,6/6/22
11253,1,1,3,5,EVIL18,1021,6/6/22
11254,1,3,0,4,CRAZE42,1051,6/6/22
11255,1,2,0,3,DRAGN44,1048,6/6/22
11256,2,2,3,7,PHNTM51,1054,6/6/22
11257,1,2,2,5,DRAGN33,1057,6/6/22
11258,2,3,0,5,DRAGN53,1100,6/6/22
11259,0,1,1,2,CRAZE88,1139,6/6/22
11260,0,0,1,1,PHNTM33,1145,6/6/22
11261,1,0,0,1,COACH21,1154,6/6/22
11262,4,0,0,4,COACH22,1154,6/6/22
11263,0,1,5,6,DRAGN42,1142,6/6/22
11264,1,0,3,4,SCARE18,1151,6/6/22
11265,2,1,3,6,Dragon05,1148,6/6/22
11266,3,1,1,5,SMALL04,1200,6/6/22
11267,3,1,1,5,SMALL05,1203,6/6/22
11268,2,2,2,6,HOOK32,1239,6/6/22
11269,1,1,2,4,HOOK04,1242,6/6/22
11270,2,2,4,8,GOLEM61,1245,6/6/22
11271,2,2,6,10,GOLEM62,1245,6/6/22
11272,2,2,6,10,GOLEM62,1245,6/6/22
11273,1,2,1,4,TAUNT21,1233,6/6/22
11274,1,2,0,3,TAUNT22,1233,6/6/22
11275,0,2,2,4,PAWS47,1251,6/6/22
11276,2,2,1,5,FURY02,1303,6/6/22
11277,2,2,5,9,CRAZE15,1306,6/6/22
11278,1,1,4,6,PAWS69,1254,6/6/22
11279,2,2,1,5,FURY01,1309,6/6/22
11280,1,2,0,3,POST61,1312,6/6/22
11281,1,2,1,4,Post62,1312,6/6/22
11282,1,2,2,5,CRAZE34,1333,6/6/22
11283,1,1,0,2,RENO71,1318,6/6/22
11284,1,1,0,2,RENO72,1318,6/6/22
11285,1,3,1,5,VEGA21,1324,6/6/22
11286,1,3,0,4,VEGA22,1324,6/6/22
11287,4,1,0,5,SMALL42,1330,6/6/22
11288,4,1,0,5,SMALL50,1348,6/6/22
11289,2,2,3,7,CRAZE13,1342,6/6/22
11290,0,1,2,3,PHNTM50,1345,6/6/22
11291,3,1,0,4,SMALL53,1357,6/6/22
11292,2,2,5,9,RECON85,1354,6/6/22
11293,1,1,2,4,SHINR81,1400,6/6/22
11294,1,1,2,4,SHINR82,1400,6/6/22
11295,0,2,3,5,DAWG02,1351,6/6/22
11296,4,1,0,5,SMALL63,1421,6/6/22
11297,2,2,3,7,HANG51,1412,6/6/22
11298,1,2,4,7,HANG52,1415,6/6/22
11299,1,1,0,2,STAB11,1406,6/6/22
11300,1,1,1,3,STAB12,1406,6/6/22
11301,0,2,4,6,DRAGN71,1418,6/6/22
11302,4,1,1,6,CREEP31,1609,6/6/22
11303,4,1,1,6,SMALL70,1436,6/6/22
11304,1,2,3,6,WIRE31,1615,6/6/22
11305,4,2,1,7,WIRE32,1430,6/6/22
11306,1,1,5,7,DAWG09,1442,6/6/22
11307,2,1,1,4,BALL08,1445,6/6/22
11308,1,1,2,4,DRAGN55,1439,6/6/22
11309,2,1,2,5,DRAGN01,1448,6/6/22
11310,5,1,1,7,SMALL31,1603,6/6/22
11311,0,2,3,5,DRAGN05,1615,6/6/22
11312,2,1,3,6,DRAGN51,1609,6/6/22
11313,2,2,5,9,PHNTM51,1606,6/6/22
11314,1,2,2,5,TORA21,1557,6/6/22
11315,1,2,2,5,TORA22,1557,6/6/22
11316,1,1,1,3,CREEP31,1618,6/6/22
11317,4,1,1,6,CREEP32,1618,6/6/22
11318,4,2,6,12,HANG51,1654,6/6/22
11319,4,2,7,13,HANG52,1657,6/6/22
11320,2,2,5,9,SHINR81,1700,6/6/22
11321,1,2,2,5,SHINR82,1703,6/6/22
11322,2,2,6,10,DRAGN42,1618,6/6/22
11323,0,1,2,3,BADGR02,1709,6/6/22
11324,1,2,6,9,HOOK48,1700,6/6/22
11325,1,1,1,3,VEGA21,1712,6/6/22
11326,1,1,2,4,VEGA22,1712,6/6/22
11327,0,1,1,2,FILL32,1648,6/6/22
11328,1,1,4,6,BUBO32,1730,6/6/22
11329,0,1,1,2,COBRA01,1718,6/6/22
11330,3,4,0,7,FILL31,1700,6/6/22
11331,0,2,3,5,COBRA06,1721,6/6/22
11332,1,1,1,3,COACH21,1754,6/6/22
11333,4,1,0,5,COACH22,1754,6/6/22
11334,1,0,5,6,DRAGN76,2030,6/6/22
11335,4,2,1,7,HOOK76,2033,6/6/22
11336,3,0,2,5,BALL36,2042,6/6/22
11337,2,0,1,3,BALL22,2054,6/6/22
11338,2,0,2,4,BALL08,2057,6/6/22
11339,2,1,1,4,BALL18,2100,6/6/22
11340,3,1,2,6,BALL02,2103,6/6/22
11341,4,1,2,7,BALL65,2036,6/6/22
11342,2,1,3,6,BALL61,2039,6/6/22
11343,0,4,4,8,CRAZE13,921,6/7/22
11344,2,1,1,4,HOOK04,1003,6/7/22
11345,0,2,2,4,DRAGN37,1000,6/7/22
11346,2,2,3,7,CRAZE77,1015,6/7/22
11347,1,2,5,8,SCARE18,1018,6/7/22
11348,0,2,1,3,DRAGN61,957,6/7/22
11349,0,4,0,4,CRAZY88,1027,6/7/22
11350,2,2,1,5,EVIL18,1009,6/7/22
11351,2,4,2,8,CRAZE09,1030,6/7/22
11352,1,8,0,9,CRAZE42,1045,6/7/22
11353,0,3,1,4,RECON81,1039,6/7/22
11354,1,2,0,3,STAB11,1042,6/7/22
11355,1,3,0,4,STAB12,1033,6/7/22
11356,1,1,3,5,DRAGN55,1045,6/7/22
11357,0,4,0,4,CRAZE44,1048,6/7/22
11358,1,0,1,2,DAWG09,1051,6/7/22
11359,0,2,4,6,HOOK48,939,6/7/22
11360,0,3,1,4,DRAGN,1139,6/7/22
11361,2,5,3,10,SLOW11,1127,6/7/22
11362,1,5,1,7,SLOW12,1127,6/7/22
11363,0,4,4,8,CRAZE13,921,6/7/22
11364,2,5,3,10,SLOW11,1127,6/7/22
11365,1,5,1,7,SLOW12,1130,6/7/22
11366,0,2,2,4,DRAGN37,1000,6/7/22
11367,2,2,3,7,CRAZE77,1015,6/7/22
11368,1,1,0,2,HOOK04,1003,6/7/22
11369,1,2,5,8,SCARE18,1018,6/7/22
11370,0,2,3,5,DRAGN61,957,6/7/22
11371,0,4,0,4,CRAZY88,1027,6/7/22
11372,2,2,1,5,EVIL18,1009,6/7/22
11373,1,8,0,9,CRAZE42,1042,6/7/22
11374,2,4,2,8,CRAZE09,1030,6/7/22
11375,0,3,1,4,RECON81,1039,6/7/22
11376,1,2,0,3,STAB11,1033,6/7/22
11377,1,2,0,3,STAB12,1036,6/7/22
11378,1,1,3,5,DRAGN55,1045,6/7/22
11379,0,4,0,4,CRAZE44,1048,6/7/22
11380,1,0,1,2,DAWG09,1051,6/7/22
11381,0,2,4,6,HOOK48,939,6/7/22
11382,1,3,0,4,DRAGN05,1130,6/7/22
11383,0,3,1,4,DRAGN02,1133,6/7/22
11384,0,4,4,8,BUBO32,1133,6/7/22
11385,1,2,3,6,DRAGN01,1142,6/7/22
11386,0,3,1,4,FILL21,1154,6/7/22
11387,0,3,1,4,FILL22,1157,6/7/22
11388,1,4,3,8,BALL03,1151,6/7/22
11389,1,1,0,2,DRAGN69,1139,6/7/22
11390,1,3,3,7,GOLEM61,1239,6/7/22
11391,1,3,3,7,GOLEM62,1239,6/7/22
11392,1,3,0,4,LOST21,1230,6/7/22
11393,1,3,0,4,LOST22,1233,6/7/22
11394,0,1,0,1,SPECK69,1200,6/7/22
11395,1,3,3,7,SHINR81,1312,6/7/22
11396,1,3,5,9,SHINR82,1315,6/7/22
11397,2,4,1,7,POST61,1318,6/7/22
11398,4,4,2,10,POST62,1321,6/7/22
11399,2,4,1,7,RENO71,1324,6/7/22
11400,1,4,1,6,RENO72,1327,6/7/22
11401,0,3,2,5,PAWS16,1330,6/7/22
11402,4,0,0,4,SMALL88,1336,6/7/22
11403,1,5,2,8,BALL08,1333,6/7/22
11404,1,4,3,8,COBRA06,1339,6/7/22
11405,3,1,2,6,DAWG02,1345,6/7/22
11406,2,3,2,7,EVIL18,1348,6/7/22
11407,3,4,5,12,DRAGN18,1357,6/7/22
11408,1,0,2,3,CRAZE88,1415,6/7/22
11409,1,0,3,4,WIRE31,1403,6/7/22
11410,1,0,2,3,WIRE32,1406,6/7/22
11411,0,1,3,4,CRAZE13,1400,6/7/22
11412,1,2,2,5,CRAZE42,1427,6/7/22
11413,1,5,1,7,HANG51,1415,6/7/22
11414,4,1,1,6,SMALL99,1418,6/7/22
11415,1,1,4,6,DRAGN76,1436,6/7/22
11416,1,2,4,7,DRAGN55,1433,6/7/22
11417,0,2,1,3,RECON85,1442,6/7/22
11418,0,5,3,8,LOOT06,1445,6/7/22
11419,2,2,0,4,BALL78,1442,6/7/22
11420,0,2,5,7,DRAGN,1545,6/7/22
11421,1,2,4,7,BUBO32,1548,6/7/22
11422,1,1,3,5,SCARE11,1554,6/7/22
11423,0,1,4,5,PHNTM33,1557,6/7/22
11424,3,0,2,5,SMALL25,1551,6/7/22
11425,1,2,0,3,TORA21,1609,6/7/22
11426,1,2,2,5,TORA22,1612,6/7/22
11427,3,1,1,5,SMALL52,1654,6/7/22
11428,3,1,2,6,SMALL53,1657,6/7/22
11429,3,1,0,4,SMALL51,1651,6/7/22
11430,0,3,3,6,HOOK72,1306,6/7/22
11431,3,1,1,5,SMALL54,1700,6/7/22
11432,0,1,4,5,DAWG09,1648,6/7/22
11433,1,2,0,3,HOOK38,1715,6/7/22
11434,1,2,2,5,WIRE31,1709,6/7/22
11435,1,2,2,5,WIRE32,1709,6/7/22
11436,1,2,1,4,AXLE11,1703,6/7/22
11437,0,4,2,6,DRAGN71,1718,6/7/22
11438,1,1,2,4,RECON85,2033,6/7/22
11439,1,1,2,4,DRAGN94,2042,6/7/22
11440,2,1,2,5,HOOK76,2030,6/7/22
11441,3,2,0,5,PAWS34,2057,6/7/22
11442,2,1,3,6,BALL65,2115,6/7/22
11443,2,1,3,6,HOOK71,2027,6/7/22
11444,2,1,1,4,BALL83,2039,6/7/22
11445,2,1,2,5,BALL22,2054,6/7/22
11446,2,1,1,4,BALL78,2100,6/7/22
11447,2,1,3,6,BALL18,2103,6/7/22
11448,2,1,2,5,HOOK21,2045,6/7/22
11449,2,1,3,6,HOOK32,2130,6/7/22
11450,2,1,3,6,HOOK31,2133,6/7/22
11451,2,1,2,5,HOOK38,2139,6/7/22
11452,1,2,2,5,DRAGN 55,1100,6/8/22
11453,1,4,5,10,DRAGN42,1245,6/8/22
11454,0,5,0,5,GIZMO31,1145,6/8/22
11455,1,3,0,4,GIZMO32,1148,6/8/22
11456,1,6,3,10,GOLEM61,1248,6/8/22
11457,1,6,6,13,GOLEM62,1248,6/8/22
11458,2,4,1,7,LOOT50,1015,6/8/22
11459,1,5,5,11,WIRE31,1300,6/8/22
11460,1,5,3,9,WIRE32,1303,6/8/22
11461,1,4,4,9,VEGA21,1230,6/8/22
11462,1,4,1,6,VEGA22,1233,6/8/22
11463,5,2,2,9,HOOK05,1242,6/8/22
11464,2,4,1,7,RECON71,1302,6/8/22
11465,2,4,3,9,DRAGN02,1254,6/8/22
11466,2,1,1,4,BALL72,1239,6/8/22
11467,1,4,0,5,SHINR81,1309,6/8/22
11468,1,4,1,6,SHINR82,1309,6/8/22
11469,2,2,1,5,FURY05,1306,6/8/22
11470,3,1,1,5,RECON02,1321,6/8/22
11471,1,1,2,4,COBRA01,1333,6/8/22
11472,1,0,0,1,CREEP31,1327,6/8/22
11473,1,0,0,1,CREEP32,1330,6/8/22
11474,1,2,3,6,CRAZE46,1339,6/8/22
11475,0,0,2,2,COBRA06,1342,6/8/22
11476,0,3,1,4,CRAZE34,1334,6/8/22
11477,1,1,3,5,SCARE18,1403,6/8/22
11478,0,2,4,6,CRAZE13,1351,6/8/22
11479,0,2,0,2,EVIL18,1354,6/8/22
11480,1,1,2,4,RECON85,1348,6/8/22
11481,2,1,1,4,DRAGN41,1357,6/8/22
11482,2,0,2,4,DAWG02,1345,6/8/22
11483,0,3,2,5,CRAZE88,1439,6/8/22
11484,1,7,1,9,AXLE11,1406,6/8/22
11485,1,7,2,10,AXLE12,1409,6/8/22
11486,1,0,1,2,DRAGN51,1430,6/8/22
11487,1,6,4,11,HANG51,1412,6/8/22
11488,1,6,2,9,HANG52,1412,6/8/22
11489,0,2,4,6,DRAGN75,1448,6/8/22
11490,0,3,4,7,LOOT08,1436,6/8/22
11491,0,1,2,3,DRAGN33,1427,6/8/22
11492,0,4,1,5,RECON81,1433,6/8/22
11493,3,0,2,5,DRAGN55,1442,6/8/22
11494,0,5,0,5,BALL88,1451,6/8/22
11495,1,2,3,6,PHNTM33,1545,6/8/22
11496,0,3,3,6,HOOK94,1536,6/8/22
11497,0,0,7,7,DRAGN42,1609,6/8/22
11498,2,1,2,5,EPIC58,1703,6/8/22
11499,1,1,3,5,SHINR81,1654,6/8/22
11500,1,1,2,4,SHINR82,1657,6/8/22
11501,2,2,1,5,EPIC06,1700,6/8/22
11502,1,1,2,4,COACH21,1706,6/8/22
11503,1,1,0,2,COACH22,1709,6/8/22
11504,0,1,1,2,COBRA08,1718,6/8/22
11505,1,1,2,4,GOLEM21,1618,6/8/22
11506,1,1,0,2,GOLEM22,1621,6/8/22
11507,1,1,1,3,HANG51,1712,6/8/22
11508,1,1,3,5,HANG52,1712,6/8/22
11509,1,2,4,7,STAB11,1718,6/8/22
11510,1,2,2,5,STAB12,1718,6/8/22
11511,1,1,1,3,HOOK38,1742,6/8/22
11512,1,1,2,4,AXLE11,1736,6/8/22
11513,1,1,3,5,AXLE12,1739,6/8/22
11514,0,0,0,0,DRAGN42,0,6/10/22
11515,0,0,7,7,DRAGN42,730,6/10/22
11516,0,3,3,6,CRAZE61,736,6/10/22
11517,0,3,7,10,PAWS15,733,6/10/22
11518,1,3,2,6,STAB11,745,6/10/22
11519,1,3,4,8,STAB11,745,6/10/22
11520,1,1,2,4,SCARE71,742,6/10/22
11521,0,1,6,7,BALL08,751,6/10/22
11522,2,4,4,10,BALL31,754,6/10/22
11523,0,1,5,6,COBRA06,757,6/10/22
11524,3,0,4,7,SMALL88,803,6/10/22
11525,0,0,6,6,LOOT08,806,6/10/22
11526,0,2,2,4,COBRA05,800,6/10/22
11527,2,1,1,4,EVIL18,812,6/10/22
11528,3,1,3,7,LOOT50,815,6/10/22
11529,0,0,5,5,CRAZE12,809,6/10/22
11530,1,1,7,9,DRAGN13,821,6/10/22
11531,2,1,7,10,PAWS13,818,6/10/22
11532,3,0,2,5,SMALL99,824,6/10/22
11533,3,0,0,3,SMALL65,827,6/10/22
11534,3,1,0,4,SMALL67,833,6/10/22
11535,3,1,0,4,SMALL70,836,6/10/22
11536,3,1,0,4,SMALL71,839,6/10/22
11537,3,0,4,7,SMALL66,830,6/10/22
11538,0,1,1,2,RECON88,842,6/10/22
11539,0,1,3,4,RECON81,845,6/10/22
11540,1,1,1,3,POST61,848,6/10/22
11541,4,1,1,6,POST62,851,6/10/22
11542,1,1,15,17,SHINR81,854,6/10/22
11543,1,1,1,3,SHINR81,854,6/10/22
11544,2,2,3,7,LOST81,942,6/10/22
11545,2,2,5,9,LOST82,942,6/10/22
11546,1,2,1,4,TORA51,948,6/10/22
11547,1,2,2,5,TORA52,957,6/10/22
11548,1,1,2,4,PAWS33,1042,6/10/22
11549,2,1,6,9,CRAZE15,1115,6/10/22
11550,1,0,2,3,ETCH41,1115,6/10/22
11551,1,1,4,6,ETCH42,1118,6/10/22
11552,2,1,1,4,GHOST69,1112,6/10/22
11553,1,1,6,8,COBRA05,1130,6/10/22
11554,1,4,5,10,HANG51,1121,6/10/22
11555,1,4,2,7,HANG52,1124,6/10/22
11556,2,0,4,6,CREEP31,1106,6/10/22
11557,2,0,4,6,CREEP32,1109,6/10/22
11558,3,0,2,5,SMALL67,1133,6/10/22
11559,1,1,5,7,BALL31,1130,6/10/22
11560,2,1,2,5,EVIL18,1145,6/10/22
11561,4,0,3,7,SMALL74,1148,6/10/22
11562,2,1,4,7,BALL02,1154,6/10/22
11563,1,2,7,10,COOT08,1139,6/10/22
11564,2,0,4,6,CRAZE12,1142,6/10/22
11565,1,1,3,5,CRAZE34,1136,6/10/22
11566,1,0,3,4,EASY86,11130,6/10/22
11567,3,1,4,8,LOOT50,11510,6/10/22
11568,1,1,2,4,POST61,1203,6/10/22
11569,1,1,3,5,POST62,1206,6/10/22
11570,1,0,0,1,VEGA21,1209,6/10/22
11571,1,0,2,3,VEGA22,1209,6/10/22
11572,2,1,1,4,AXLE11,1157,6/10/22
11573,2,1,2,5,AXLE12,1200,6/10/22
11574,1,0,0,1,DRAGN96,1224,6/10/22
11575,3,1,1,5,SMALL20,1236,6/10/22
11576,1,0,3,4,STAB11,1218,6/10/22
11577,1,0,3,4,STAB11,1218,6/10/22
11578,2,1,8,11,GIZMO11,1230,6/10/22
11579,4,1,2,7,GIZMO12,1230,6/10/22
11580,2,1,3,6,SLOW21,1330,6/10/22
11581,1,1,0,2,SLOW22,1330,6/10/22
11582,1,0,5,6,BALL19,1339,6/10/22
11583,1,0,3,4,SPOT91,1345,6/10/22
11584,4,0,0,4,SPOT92,1345,6/10/22
11585,1,2,1,4,ETCH41,1412,6/10/22
11586,1,0,3,4,HANG51,1351,6/10/22
11587,1,0,1,2,HANG52,1351,6/10/22
11588,2,1,1,4,TORA71,1357,6/10/22
11589,2,1,0,3,TORA72,1357,6/10/22
11590,1,1,1,3,CREEP31,1403,6/10/22
11591,1,1,3,5,CREEP32,1403,6/10/22
11592,3,1,2,6,SMALL61,1415,6/10/22
11593,0,2,2,4,CRAZE42,1418,6/10/22
11594,1,0,5,6,PHNTM33,1433,6/10/22
11595,3,3,4,10,RECON01,1336,6/10/22
11596,1,1,3,5,DRAGN55,1424,6/10/22
11597,3,1,3,7,DRAGN33,1421,6/10/22
11598,0,1,1,2,HOOK41,1436,6/10/22
11599,0,1,9,10,DRAGN42,1439,6/10/22
11600,1,1,1,3,DRAGN51,1430,6/10/22
11601,0,1,4,5,DRAGN53,1427,6/10/22
11602,3,1,0,4,SMALL72,1442,6/10/22
11603,2,1,6,9,FURY05,1448,6/10/22
11604,0,2,2,4,HOOK02,1457,6/10/22
11605,3,3,2,8,GHOST69,1451,6/10/22
11606,0,4,1,5,COBRA08,1654,6/10/22
11607,0,4,5,9,COBRA06,1506,6/10/22
11608,0,4,6,10,COBRA05,1515,6/10/22
11609,1,2,7,10,COBRA01,1512,6/10/22
11610,2,2,9,13,LOOT08,1521,6/10/22
11611,2,4,6,12,BALL42,1524,6/10/22
11612,1,4,4,9,HOOK32,1533,6/10/22
11613,0,3,4,7,CRAZE34,1524,6/10/22
11614,2,8,9,19,AXLE11,1712,6/10/22
11615,0,0,2,2,PAWS61,1833,6/10/22
11616,1,1,3,5,Hook47,1839,6/10/22
11617,2,1,1,4,Hook05,1836,6/10/22
11618,2,2,3,7,Hook23,1909,6/10/22
11619,1,1,3,5,Vegas21,1727,6/10/22
11620,2,1,3,6,Vegas22,1730,6/10/22
11621,1,1,4,6,Hook72,1733,6/10/22
11622,1,1,1,3,Wire31,1745,6/10/22
11623,4,1,1,6,Wire32,1745,6/10/22
11624,0,2,6,8,Dragn71,1736,6/10/22
11625,1,1,2,4,Dragn55,1751,6/10/22
11626,0,2,2,4,Loot06,1706,6/10/22
11627,1,1,3,5,PAWS69,1712,6/10/22
11628,3,1,1,5,SMALL06,1806,6/10/22
11629,1,2,4,7,DRAGN53,1754,6/10/22
11630,0,3,1,4,HOOK38,1715,6/10/22
11631,3,2,1,6,SMALL72,1742,6/10/22
11632,3,2,1,6,SMALL71,1739,6/10/22
11633,1,2,3,6,HOOK03,1718,6/10/22
11634,1,2,1,4,HOOK76,1721,6/10/22
11635,1,2,2,5,HOOK92,1703,6/10/22
11636,1,1,5,7,DRAGN33,1809,6/10/22
11637,3,1,2,6,SMALL05,1703,6/10/22
11638,1,1,7,9,BALL18,1759,6/10/22
11639,0,1,3,4,GOLEM41,1648,6/10/22
11640,1,5,7,13,CREEP31,803,6/13/22
11641,1,5,5,11,CREEP31,803,6/13/22
11642,1,4,5,10,AXLE11,809,6/13/22
11643,1,4,3,8,AXLE11,809,6/13/22
11644,0,4,4,8,CRAZE25,815,6/13/22
11645,0,4,4,8,LOOT08,827,6/13/22
11646,0,5,8,13,RHINO99,800,6/13/22
11647,0,4,3,7,DAWG02,824,6/13/22
11648,1,4,5,10,COBRA01,836,6/13/22
11649,0,4,2,6,COBRA05,0,6/13/22
11650,1,3,1,5,RECON81,918,6/13/22
11651,0,2,2,4,COBRA05,848,6/13/22
11652,1,5,0,6,CRAZE12,915,6/13/22
11653,0,3,2,5,CRAZE34,851,6/13/22
11654,2,6,0,8,SCOW81,933,6/13/22
11655,2,6,0,8,SCOW81,933,6/13/22
11656,2,5,0,7,HOOK92,921,6/13/22
11657,0,2,4,6,DRAGN38,924,6/13/22
11658,2,3,5,10,WIRE31,954,6/13/22
11659,1,3,3,7,WIRE32,957,6/13/22
11660,7,3,2,12,HOOK11,939,6/13/22
11661,2,4,2,8,EPIC09,948,6/13/22
11662,1,4,1,6,BALL52,951,6/13/22
11663,2,5,3,10,FURY05,1000,6/13/22
11664,2,3,4,9,CRAZE15,1003,6/13/22
11665,1,3,1,5,VEGA21,1018,6/13/22
11666,1,3,2,6,VEGA22,1018,6/13/22
11667,2,4,0,6,FURY02,1006,6/13/22
11668,1,5,1,7,GHOST02,1009,6/13/22
11669,2,6,2,10,SLOW81,1024,6/13/22
11670,1,6,0,7,SLOW82,1027,6/13/22
11671,2,4,2,8,BALL64,942,6/13/22
11672,0,4,7,11,BALL18,1015,6/13/22
11673,2,2,0,4,LOST21,1012,6/13/22
11674,2,3,0,5,LOST22,1012,6/13/22
11675,1,5,2,8,SCARE99,1118,6/13/22
11676,1,4,0,5,CRAZE42,1136,6/13/22
11677,1,4,2,7,GOLEM61,1127,6/13/22
11678,1,4,4,9,GOLEM62,1130,6/13/22
11679,0,4,3,7,DRAGN53,1142,6/13/22
11680,1,5,3,9,DRAGN33,1139,6/13/22
11681,0,4,2,6,DRAGN51,1148,6/13/22
11682,0,5,6,11,HOOK65,1136,6/13/22
11683,1,4,3,8,DRAGN55,1145,6/13/22
11684,0,4,3,7,PAWS76,1157,6/13/22
11685,1,5,2,8,AXLE11,1200,6/13/22
11686,1,5,2,8,AXLE12,1203,6/13/22
11687,0,3,4,7,HOOK05,1209,6/13/22
11688,0,5,4,9,DRAGN38,1206,6/13/22
11689,1,5,1,7,CRAZE88,1215,6/13/22
11690,4,5,6,15,BUBO32,1218,6/13/22
11691,1,5,4,10,SPOT91,1231,6/13/22
11692,1,5,8,14,SPOT92,1224,6/13/22
11693,3,6,4,13,HOOK48,1212,6/13/22
11694,1,4,3,8,STAB11,1227,6/13/22
11695,1,4,3,8,STAB22,1230,6/13/22
11696,2,5,3,10,SHINR81,1233,6/13/22
11697,1,5,5,11,SHINR82,1236,6/13/22
11698,0,4,4,8,CRAZE76,1303,6/13/22
11699,1,4,5,10,CRAZE25,1300,6/13/22
11700,1,6,1,8,ETCH41,1318,6/13/22
11701,1,6,2,9,ETCH42,1321,6/13/22
11702,3,3,6,12,RECON85,1315,6/13/22
11703,3,5,2,10,RECON83,1309,6/13/22
11704,2,6,0,8,SLOW82,1330,6/13/22
11705,1,7,5,13,CREEP31,1333,6/13/22
11706,1,7,3,11,CREEP32,1336,6/13/22
11707,2,4,6,12,LOOT08,1436,6/13/22
11708,0,5,5,10,DAWG08,1439,6/13/22
11709,0,2,5,7,COBRA08,1448,6/13/22
11710,0,5,4,9,DRAGN34,1433,6/13/22
11711,0,5,5,10,DAWG02,1442,6/13/22
11712,0,3,1,4,GHOST69,1454,6/13/22
11713,0,3,6,9,CRAZE41,1451,6/13/22
11714,2,3,2,7,BALL31,1445,6/13/22
11715,2,4,2,8,EPIC06,1500,6/13/22
11716,0,3,2,5,CRAZE34,1457,6/13/22
11717,2,3,5,10,PAWS14,1503,6/13/22
11718,2,6,4,12,FURY05,1515,6/13/22
11719,0,5,5,10,BALL58,1506,6/13/22
11720,2,5,4,11,ball16,1600,6/13/22
11721,,0,0,,FURY02,1518,6/13/22
11722,2,5,3,10,FURY02,1518,6/13/22
11723,1,5,1,7,RENO71,1527,6/13/22
11724,3,6,3,12,SMALL20,1536,6/13/22
11725,0,5,4,9,HOOK66,1533,6/13/22
11726,2,6,1,9,VEGA21,1539,6/13/22
11727,1,6,3,10,VEGA22,1539,6/13/22
11728,1,5,1,7,DRAGN51,1548,6/13/22
11729,2,3,3,8,DRAGN55,1554,6/13/22
11730,0,6,6,12,DRAGN53,1545,6/13/22
11731,5,2,0,7,SMALL25,1545,6/13/22
11732,5,2,0,7,SMALL25,1551,6/13/22
11733,0,1,3,4,PAWS69,1609,6/13/22
11734,1,5,2,8,STAB11,1615,6/13/22
11735,1,5,0,6,STAB12,1615,6/13/22
11736,1,4,3,8,Axle11,1621,6/13/22
11737,4,4,1,9,Axle12,1621,6/13/22
11738,1,4,6,11,WIRE31,1627,6/13/22
11739,1,4,5,10,WIRE32,1627,6/13/22
11740,1,6,4,11,VEGA21,800,6/14/22
11741,1,6,3,10,VEGA22,800,6/14/22
11742,1,3,4,8,Axle11,806,6/14/22
11743,1,3,4,8,AXLE12,806,6/14/22
11744,1,5,1,7,STAB11,812,6/14/22
11745,4,5,1,10,STAB12,815,6/14/22
11746,1,3,4,8,SCARE71,824,6/14/22
11747,1,1,5,7,DAWG02,827,6/14/22
11748,1,3,2,6,SCARE72,830,6/14/22
11749,1,3,5,9,COACH21,818,6/14/22
11750,4,3,1,8,COACH22,821,6/14/22
11751,2,1,8,11,LOOT08,842,6/14/22
11752,0,3,5,8,DAWG08,842,6/14/22
11753,0,3,4,7,EVIL18,839,6/14/22
11754,0,3,5,8,COBRA01,830,6/14/22
11755,0,2,4,6,COBRA05,848,6/14/22
11756,1,3,2,6,BALL38,845,6/14/22
11757,3,2,1,6,SMALL75,851,6/14/22
11758,2,2,1,5,SMALL77,857,6/14/22
11759,1,3,2,6,SPEAK69,854,6/14/22
11760,0,3,4,7,CRAZE41,903,6/14/22
11761,2,3,0,5,EPIC02,909,6/14/22
11762,3,2,4,9,EPIC09,906,6/14/22
11763,1,5,3,9,SHINR81,912,6/14/22
11764,1,5,0,6,SHINR82,915,6/14/22
11765,2,5,4,11,EPIC03,918,6/14/22
11766,0,5,4,9,PAWS15,921,6/14/22
11767,0,5,1,6,BALL91,939,6/14/22
11768,2,3,2,7,AMMO06,930,6/14/22
11769,2,3,0,5,CRAZY61,924,6/14/22
11770,4,5,1,10,RECON83,927,6/14/22
11771,1,3,2,6,HANG51,948,6/14/22
11772,1,3,1,5,HANG52,948,6/14/22
11773,2,3,1,6,FURY02,933,6/14/22
11774,3,4,0,7,SMALL27,957,6/14/22
11775,2,4,0,6,Hook92,942,6/14/22
11776,4,3,5,12,DRAGN47,1000,6/14/22
11777,0,5,5,10,HOOK71,954,6/14/22
11778,2,5,0,7,AXLE11,1003,6/14/22
11779,2,5,0,7,AXLE12,1003,6/14/22
11780,1,2,0,3,CRAZE42,1009,6/14/22
11781,2,3,2,7,DRAGN55,1021,6/14/22
11782,2,3,4,9,DRAGN53,1012,6/14/22
11783,0,2,0,2,DRAGN51,1018,6/14/22
11784,0,5,6,11,HOOK38,1000,6/14/22
11785,1,2,3,6,PAWS76,1024,6/14/22
11786,2,5,2,9,TORA21,1030,6/14/22
11787,2,5,4,11,TORA22,1033,6/14/22
11788,1,1,1,3,BALL99,1027,6/14/22
11789,0,1,1,2,PAWS88,1121,6/14/22
11790,0,2,1,3,HOOK99,1118,6/14/22
11791,2,4,0,6,SLOW71,1124,6/14/22
11792,1,4,0,5,SLOW72,1124,6/14/22
11793,1,4,0,5,GOLEM61,1130,6/14/22
11794,1,4,4,9,GOLEM62,1133,6/14/22
11795,4,2,1,7,STAB11,1024,6/14/22
11796,1,5,2,8,VEGA21,1145,6/14/22
11797,1,5,2,8,VEGA22,1148,6/14/22
11798,0,5,3,8,PAWS11,1142,6/14/22
11799,0,4,2,6,DRAGN34,1154,6/14/22
11800,0,2,0,2,HOOK22,1115,6/14/22
11801,1,5,0,6,LOOT50,1157,6/14/22
11802,0,5,1,6,LOOT55,1203,6/14/22
11803,1,4,5,10,DRAGN48,1206,6/14/22
11804,0,3,5,8,BALL24,1212,6/14/22
11805,0,2,3,5,RECON08,1221,6/14/22
11806,0,2,3,5,RECON69,1221,6/14/22
11807,2,3,0,5,SMALL07,1209,6/14/22
11808,0,4,1,5,DRAGN31,1151,6/14/22
11809,1,4,0,5,CREEP31,1215,6/14/22
11810,4,4,1,9,CREEP32,1218,6/14/22
11811,2,3,0,5,CRAZE14,1236,6/14/22
11812,0,2,3,5,CRAZE12,1233,6/14/22
11813,0,2,4,6,DAWG02,1230,6/14/22
11814,1,5,2,8,BALL48,1221,6/14/22
11815,4,4,1,9,SMALL13,1221,6/14/22
11816,0,2,4,6,COBRA08,1239,6/14/22
11817,0,3,5,8,COBRA05,1242,6/14/22
11818,2,5,2,9,COBRA01,1257,6/14/22
11819,0,3,5,8,PHNTM77,1248,6/14/22
11820,0,3,5,8,EPIC01,1245,6/14/22
11821,0,3,5,8,CRAZE41,1251,6/14/22
11822,2,4,2,8,EPIC08,1254,6/14/22
11823,1,2,5,8,SCARE72,1303,6/14/22
11824,1,3,1,5,CRAZY61,1304,6/14/22
11825,1,2,3,6,CRAZE15,1306,6/14/22
11826,1,2,3,6,RECON83,1312,6/14/22
11827,1,2,3,6,FURY02,1315,6/14/22
11828,1,4,1,6,RENO71,1324,6/14/22
11829,1,4,3,8,RENO72,1327,6/14/22
11830,0,4,1,5,RECON03,1333,6/14/22
11831,1,2,1,4,DRAGN96,1336,6/14/22
11832,3,3,2,8,RECON85,1330,6/14/22
11833,0,2,1,3,AMMO06,1321,6/14/22
11834,1,2,5,8,DRAGN75,1318,6/14/22
11835,3,3,2,8,SCARE78,1457,6/14/22
11836,1,2,3,6,SHINR81,1451,6/14/22
11837,1,2,1,4,SHINR82,1451,6/14/22
11838,3,3,6,12,DRAGN53,1500,6/14/22
11839,3,3,3,9,DRAGN55,1506,6/14/22
11840,0,2,3,5,DRAGN51,1428,6/14/22
11841,1,3,3,7,STAB11,1527,6/14/22
11842,1,3,4,8,STAB12,1527,6/14/22
11843,2,2,1,5,SMALL23,1545,6/14/22
11844,0,4,8,12,HOOK03,1518,6/14/22
11845,1,2,2,5,ETCH41,1521,6/14/22
11846,1,2,1,4,ETCH42,1524,6/14/22
11847,2,5,6,13,WIRE31,1533,6/14/22
11848,2,5,6,13,WIRE32,1536,6/14/22
11849,0,3,2,5,DRAGN01,1548,6/14/22
11850,0,3,4,7,DRAGN41,1551,6/14/22
11851,1,3,3,7,VEGA21,1539,6/14/22
11852,4,3,1,8,VEGA22,1539,6/14/22
11853,4,3,1,8,VEGA22,1539,6/14/22
11854,1,3,2,6,STAB11,803,6/15/22
11855,4,3,1,8,STAB12,803,6/15/22
11856,1,3,2,6,PAWS16,800,6/15/22
11857,1,4,3,8,BALL69,809,6/15/22
11858,1,4,5,10,AXLE11,812,6/15/22
11859,1,4,5,10,AXLE12,812,6/15/22
11860,3,2,3,8,SCARE64,827,6/15/22
11861,0,3,4,7,COBRA01,842,6/15/22
11862,1,2,5,8,LOOT08,824,6/15/22
11863,4,1,2,7,SMALL16,830,6/15/22
11864,3,3,2,8,SMALL63,821,6/15/22
11865,0,2,2,4,COBRA08,836,6/15/22
11866,0,3,1,4,COBRA06,845,6/15/22
11867,3,1,2,6,SMALL78,851,6/15/22
11868,0,1,3,4,PHNTM50,848,6/15/22
11869,0,3,1,4,CRAZE34,839,6/15/22
11870,0,2,4,6,CRAZE41,854,6/15/22
11871,1,1,3,5,BALL35,857,6/15/22
11872,3,3,2,8,SCARE72,900,6/15/22
11873,3,2,6,11,RECON82,906,6/15/22
11874,2,2,1,5,RECON85,903,6/15/22
11875,0,7,0,7,EPIC02,924,6/15/22
11876,1,5,2,8,TORA21,918,6/15/22
11877,1,5,3,9,TORA22,918,6/15/22
11878,3,2,2,7,DRAGN11,909,6/15/22
11879,0,5,5,10,AMMO08,818,6/15/22
11880,1,3,4,8,RECON88,842,6/15/22
11881,2,3,2,7,EPIC06,927,6/15/22
11882,2,3,5,10,EPIC03,915,6/15/22
11883,1,2,1,4,CRAZE15,939,6/15/22
11884,1,4,6,11,WIRE31,930,6/15/22
11885,1,4,0,5,WIRE32,930,6/15/22
11886,1,4,3,8,RENO71,945,6/15/22
11887,1,4,2,7,RENO72,945,6/15/22
11888,2,4,0,6,FURY02,942,6/15/22
11889,3,4,0,7,SMALL25,951,6/15/22
11890,0,5,0,5,DRAGN51,1003,6/15/22
11891,3,4,1,8,SMALL26,954,6/15/22
11892,1,4,3,8,VEGA21,957,6/15/22
11893,1,4,3,8,VEGA22,957,6/15/22
11894,1,5,3,9,DRAGN53,1006,6/15/22
11895,1,4,3,8,DRAGN76,1009,6/15/22
11896,2,4,1,7,BALL67,1018,6/15/22
11897,2,3,0,5,PAWS44,1015,6/15/22
11898,3,4,0,7,HOOK92,1012,6/15/22
11899,2,7,2,11,SLOW51,1024,6/15/22
11900,1,7,0,8,SLOW52,1024,6/15/22
11901,0,5,3,8,LOOT48,1036,6/15/22
11902,0,5,3,8,PAWS25,1021,6/15/22
11903,0,2,4,6,BALL48,1027,6/15/22
11904,1,2,1,4,BALL41,1024,6/15/22
11905,2,3,3,8,TORA31,1118,6/15/22
11906,3,3,2,8,TORA32,1118,6/15/22
11907,0,5,4,9,HOOK03,1127,6/15/22
11908,0,2,0,2,HOOK32,1115,6/15/22
11909,0,6,6,12,HOOK47,1124,6/15/22
11910,2,4,3,9,SLOW61,1136,6/15/22
11911,2,4,7,13,SLOW62,1136,6/15/22
11912,1,5,4,10,AXEL11,1130,6/15/22
11913,1,5,0,6,AXEL12,1130,6/15/22
11914,1,4,1,6,ETCH21,1148,6/15/22
11915,1,4,0,5,ETCH22,1148,6/15/22
11916,1,5,2,8,VEGA41,1157,6/15/22
11917,1,5,4,10,VEGA42,1157,6/15/22
11918,0,4,1,5,DRAGN41,1218,6/15/22
11919,4,6,3,13,HOOK32,1209,6/15/22
11920,0,5,6,11,BADGR04,1222,6/15/22
11921,0,4,3,7,HOOK38,1215,6/15/22
11922,0,5,0,5,CRAZE42,1212,6/15/22
11923,1,5,2,8,CRAZE88,1221,6/15/22
11924,0,5,2,7,HOOK37,1206,6/15/22
11925,1,3,4,8,SHINER21,1230,6/15/22
11926,2,3,7,12,SHINER22,1233,6/15/22
11927,1,4,1,6,LOOT06,1039,6/15/22
11928,2,5,5,12,BADGER01,1248,6/15/22
11929,0,4,0,4,PHNTM55,1218,6/15/22
11930,2,2,3,7,PHNTM08,1251,6/15/22
11931,0,5,6,11,CREEP31,1236,6/15/22
11932,0,5,4,9,CREEP32,1239,6/15/22
11933,1,4,4,9,SPOT91,1242,6/15/22
11934,3,4,9,16,SPOT92,1245,6/15/22
11935,0,4,1,5,CRAZE34,1306,6/15/22
11936,0,4,2,6,CRAZE46,1300,6/15/22
11937,0,3,1,4,RECON85,1203,6/15/22
11938,2,2,5,9,PAWS12,1254,6/15/22
11939,0,6,3,9,GHOST69,1303,6/15/22
11940,2,4,0,6,BALL17,1324,6/15/22
11941,0,6,5,11,PHNTM,1312,6/15/22
11942,0,3,5,8,CRAZE41,1315,6/15/22
11943,3,4,4,11,BALL08,1257,6/15/22
11944,1,5,5,11,RECON88,1318,6/15/22
11945,1,3,3,7,SMALL95,1309,6/15/22
11946,0,5,5,10,BALL81,1321,6/15/22
11947,1,6,2,9,FURY02,1515,6/15/22
11948,2,5,2,9,EPIC08,1503,6/15/22
11949,0,6,1,7,RECON83,1518,6/15/22
11950,2,5,1,8,FURY01,1512,6/15/22
11951,2,6,2,10,EPIC02,1500,6/15/22
11952,1,5,1,7,FURY05,1521,6/15/22
11953,1,7,0,8,BALL71,1530,6/15/22
11954,1,6,2,9,HANG51,1533,6/15/22
11955,1,6,3,10,HANG52,1533,6/15/22
11956,5,5,0,10,CRAZE61,1524,6/15/22
11957,5,7,2,14,hook 61,1539,6/15/22
11958,3,5,1,9,RENO 71,1527,6/15/22
11959,2,5,4,11,RENO 72,1530,6/15/22
11960,3,6,2,11,DRAGN51,1542,6/15/22
11961,2,7,2,11,SLOW 81,1506,6/15/22
11962,5,7,1,13,SLOW 82,1509,6/15/22
11963,2,5,2,9,DRAGN55,1551,6/15/22
11964,4,5,4,13,AXLE11,1557,6/15/22
11965,5,6,0,11,DRAGN33,1545,6/15/22
11966,4,4,1,9,DRAGN53,1548,6/15/22
11967,3,6,1,10,VEGA 21,0,6/15/22
11968,0,6,4,10,VEGA 22,1609,6/15/22
11969,1,6,2,9,WIRE 31,1624,6/15/22
11970,2,6,5,13,WIRE 32,1627,6/15/22
11971,2,6,0,8,DRAGN41,1621,6/15/22
11972,5,5,0,10,DRAGN99,1603,6/15/22
11973,6,5,2,13,DRAGN32,1612,6/15/22
11974,1,5,2,8,HOOK 21,1551,6/15/22
11975,1,8,3,12,SMALL36,1618,6/15/22
11976,0,2,4,6,Evil03,815,6/16/22
11977,1,2,3,6,Stab11,803,6/16/22
11978,1,2,3,6,Stab12,803,6/16/22
11979,1,1,2,4,Creep31,809,6/16/22
11980,0,2,3,5,Fury07,821,6/16/22
11981,1,1,2,4,Scare78,830,6/16/22
11982,0,1,2,3,Rhino99,800,6/16/22
11983,2,1,3,6,Axel11,824,6/16/22
11984,0,1,4,5,Dawg02,833,6/16/22
11985,0,1,5,6,Ball48,839,6/16/22
11986,0,1,5,6,Recon99,845,6/16/22
11987,0,0,5,5,Paws12,842,6/16/22
11988,0,1,3,4,Cobra01,900,6/16/22
11989,1,1,0,2,Craze76,824,6/16/22
11990,4,1,3,8,Small65,827,6/16/22
11991,1,1,3,5,Ball19,848,6/16/22
11992,1,1,2,4,Ball38,851,6/16/22
11993,0,2,2,4,Ghost69,857,6/16/22
11994,2,2,4,8,Epic08,906,6/16/22
11995,2,0,2,4,Epic09,903,6/16/22
11996,1,3,3,7,Shinr81,909,6/16/22
11997,0,1,2,3,Craze34,854,6/16/22
11998,1,2,2,5,Recon81,924,6/16/22
11999,1,2,3,6,Scare36,942,6/16/22
12000,2,2,4,8,Wire31,915,6/16/22
12001,2,1,4,7,Craze15,921,6/16/22
12002,2,2,3,7,Recon82,927,6/16/22
12003,1,2,2,5,Hang51,936,6/16/22
12004,1,2,2,5,Hang52,936,6/16/22
12005,1,1,1,3,Dragn91,927,6/16/22
12006,1,2,0,3,Easy42,931,6/16/22
12007,4,1,3,8,Hook94,933,6/16/22
12008,1,0,3,4,Scare18,954,6/16/22
12009,0,4,1,5,Hook73,945,6/16/22
12010,1,0,4,5,Dragn53,1000,6/16/22
12011,3,1,1,5,Small24,948,6/16/22
12012,0,2,1,3,Ball88,930,6/16/22
12013,3,0,3,6,Dragn66,951,6/16/22
12014,0,1,1,2,Dragn55,1003,6/16/22
12015,1,1,1,3,Dragn51,957,6/16/22
12016,4,1,0,5,Small32,1006,6/16/22
12017,1,0,3,4,Scare06,1012,6/16/22
12018,4,4,3,11,Dragn99,1009,6/16/22
12019,1,3,4,8,Taunt21,1027,6/16/22
12020,1,3,4,8,Taunt22,1027,6/16/22
12021,2,4,5,11,Paws25,1018,6/16/22
12022,2,3,2,7,Loot06,1024,6/16/22
12023,1,2,6,9,Ball08,1024,6/16/22
12024,0,3,2,5,Paws33,1127,6/16/22
12025,3,1,2,6,Tora21,1118,6/16/22
12026,0,2,0,2,Hook01,1124,6/16/22
12027,2,3,3,8,GOLEM61,1130,6/16/22
12028,2,3,1,6,GOLEM62,1133,6/16/22
12029,1,3,3,7,TORA71,1136,6/16/22
12030,2,3,2,7,TORA72,1139,6/16/22
12031,1,2,2,5,AXLE21,1148,6/16/22
12032,4,2,0,6,AXLE22,1148,6/16/22
12033,1,3,2,6,AXLE11,1154,6/16/22
12034,1,3,6,10,AXLE12,1157,6/16/22
12035,0,2,0,2,BALL04,1142,6/16/22
12036,1,4,2,7,CREEP31,1200,6/16/22
12037,4,4,0,8,CREEP32,1203,6/16/22
12038,4,2,2,8,SMALL11,1215,6/16/22
12039,1,1,2,4,SCARE07,1206,6/16/22
12040,0,1,5,6,FURY04,1218,6/16/22
12041,1,2,0,3,VEGA21,1209,6/16/22
12042,1,2,5,8,VEGA22,1209,6/16/22
12043,0,2,5,7,HANG51,1221,6/16/22
12044,4,2,2,8,HANG52,1224,6/16/22
12045,0,3,5,8,STAB11,1227,6/16/22
12046,0,3,2,5,STAB12,1230,6/16/22
12047,0,3,4,7,EVIL03,1233,6/16/22
12048,1,4,3,8,RENO71,1242,6/16/22
12049,1,4,2,7,RENO72,1242,6/16/22
12050,3,4,8,15,AMMO08,1236,6/16/22
12051,1,2,4,7,RECON99,1254,6/16/22
12052,3,3,2,8,SMALL25,1251,6/16/22
12053,0,3,6,9,BALL41,1248,6/16/22
12054,1,5,2,8,ETCH41,1257,6/16/22
12055,1,5,1,7,ETCH42,1239,6/16/22
12056,1,5,2,8,BALL19,1309,6/16/22
12057,1,3,3,7,SCARE78,1306,6/16/22
12058,0,5,2,7,COBRA08,1309,6/16/22
12059,4,4,3,11,SMALL30,1300,6/16/22
12060,3,2,2,7,BALL42,1303,6/16/22
12061,3,3,1,7,SMALL40,1324,6/16/22
12062,0,2,4,6,CRAZE34,1312,6/16/22
12063,0,3,3,6,SPECK69,1323,6/16/22
12064,1,4,2,7,BALL31,1315,6/16/22
12065,2,4,0,6,CRAZE14,1327,6/16/22
12066,2,6,0,8,RECON85,1330,6/16/22
12067,1,6,1,8,BALL88,1500,6/16/22
12068,2,4,3,9,EPIC08,1509,6/16/22
12069,3,4,4,11,BALL03,1506,6/16/22
12070,2,6,1,9,EPIC02,1503,6/16/22
12071,1,5,6,12,COACH21,1515,6/16/22
12072,1,5,2,8,COACH22,1518,6/16/22
12073,1,4,3,8,HANG51,1521,6/16/22
12074,4,4,1,9,HANG52,1524,6/16/22
12075,0,3,5,8,DRAGN31,1512,6/16/22
12076,1,3,1,5,SCARE25,1551,6/16/22
12077,3,3,2,8,SMALL21,1539,6/16/22
12078,1,3,0,4,RENO71,1527,6/16/22
12079,1,3,2,6,RENO72,1527,6/16/22
12080,1,4,3,8,STAB11,1533,6/16/22
12081,1,4,0,5,STAB12,1533,6/16/22
12082,2,4,4,10,DRAGN53,1545,6/16/22
12083,2,5,3,10,DRAGN51,1542,6/16/22
12084,2,6,2,10,DRAGN55,1530,6/16/22
12085,1,5,2,8,CRAZE42,1554,6/16/22
12086,0,3,2,5,HOOK21,1557,6/16/22
12087,1,3,2,6,VEGA21,1606,6/16/22
12088,1,3,2,6,VEGA22,1606,6/16/22
12089,2,5,3,10,AXLE21,1603,6/16/22
12090,1,5,3,9,AXLE11,1645,6/16/22
12091,1,6,3,10,CREEP31,1618,6/16/22
12092,2,5,1,8,AXLE22,1603,6/16/22
12093,1,4,9,14,DRAGN42,1624,6/16/22
12094,2,4,3,9,HOOK48,1630,6/16/22
12095,0,4,7,11,HOOK47,1627,6/16/22
12096,2,3,2,7,DRAGN99,1633,6/16/22
12097,0,4,2,6,HOOK01,1636,6/16/22
12098,1,0,4,5,STAB11,800,6/17/22
12099,1,0,8,9,STAB12,800,6/17/22
12100,4,0,0,4,PAWS16,800,6/17/22
12101,1,1,3,5,VEGA21,806,6/17/22
12102,1,1,2,4,VEGA22,806,6/17/22
12103,3,0,1,4,SMALL62,818,6/17/22
12104,2,0,4,6,CREEP31,821,6/17/22
12105,2,0,5,7,CREEP32,824,6/17/22
12106,4,0,4,8,COACH21,827,6/17/22
12107,4,0,0,4,COACH22,827,6/17/22
12108,3,0,2,5,SMALL72,842,6/17/22
12109,1,1,3,5,BALL41,836,6/17/22
12110,2,1,4,7,BALL99,839,6/17/22
12111,0,0,2,2,COBRA01,854,6/17/22
12112,0,1,5,6,RECON08,845,6/17/22
12113,1,1,3,5,EVIL18,833,6/17/22
12114,1,1,1,3,BALL35,848,6/17/22
12115,1,1,2,4,SCARE78,851,6/17/22
12116,0,2,1,3,BALL58,906,6/17/22
12117,0,0,3,3,CRAZE46,857,6/17/22
12118,0,0,1,1,BALL38,900,6/17/22
12119,2,1,3,6,EPIC09,912,6/17/22
12120,1,1,0,2,EPIC02,903,6/17/22
12121,1,1,3,5,TORA71,900,6/17/22
12122,2,1,5,8,TORA72,903,6/17/22
12123,4,1,1,6,DRAGN91,951,6/17/22
12124,0,2,3,5,RECON03,909,6/17/22
12125,1,2,1,4,GIZMO81,933,6/17/22
12126,1,2,0,3,GIZMO82,933,6/17/22
12127,1,2,0,3,CRAZY61,939,6/17/22
12128,1,1,7,9,WIRE31,945,6/17/22
12129,1,1,1,3,WIRE32,945,6/17/22
12130,1,3,0,4,RECON83,942,6/17/22
12131,2,1,2,5,BALL51,915,6/17/22
12132,1,1,1,3,SHINR81,1000,6/17/22
12133,1,1,1,3,SHINR82,1003,6/17/22
12134,1,2,1,4,HANG51,1006,6/17/22
12135,1,2,2,5,HANG52,1009,6/17/22
12136,0,1,1,2,DRAGN51,1000,6/17/22
12137,2,0,3,5,GIZMO61,1018,6/17/22
12138,5,1,0,6,GIZMO62,1021,6/17/22
12139,0,1,0,1,CRAZE88,954,6/17/22
12140,3,2,1,6,CRAZE42,1033,6/17/22
12141,1,1,5,7,ETCH41,1012,6/17/22
12142,1,1,4,6,ETCH42,1012,6/17/22
12143,1,2,0,3,TAUNT21,1021,6/17/22
12144,2,2,0,4,TAUNT22,1021,6/17/22
12145,1,2,3,6,DRAGN55,1030,6/17/22
12146,3,1,4,8,HOOK53,1027,6/17/22
12147,0,1,1,2,DRAGN24,1006,6/17/22
12148,1,2,1,4,EASY86,1031,6/17/22
12149,1,2,1,4,RENO71,1039,6/17/22
12150,2,2,1,5,RENO72,1039,6/17/22
12151,0,2,2,4,HOOK38,1051,6/17/22
12152,0,2,3,5,HOOK37,1054,6/17/22
12153,0,2,2,4,CRAZE55,1045,6/17/22
12154,0,2,1,3,DRAGN69,1057,6/17/22
12155,0,2,1,3,HOOK41,1130,6/17/22
12156,2,3,1,6,HOOK05,1136,6/17/22
12157,2,2,4,8,BUBO32,1133,6/17/22
12158,2,2,2,6,LOOT55,1142,6/17/22
12159,2,2,3,7,EVIL03,1209,6/17/22
12160,0,2,3,5,LOOT06,1212,6/17/22
12161,4,1,3,8,STAB11,1200,6/17/22
12162,1,1,6,8,STAB12,1200,6/17/22
12163,2,2,3,7,EVIL01,1215,6/17/22
12164,3,2,6,11,RECON03,1221,6/17/22
12165,1,2,7,10,WIRE31,1206,6/17/22
12166,1,2,7,10,WIRE32,1209,6/17/22
12167,3,2,1,6,SMALL12,1218,6/17/22
12168,0,2,4,6,RECON99,1233,6/17/22
12169,1,2,4,7,BALL41,1224,6/17/22
12170,0,2,6,8,BALL08,1230,6/17/22
12171,0,2,1,3,CRAZE46,1239,6/17/22
12172,3,2,3,8,BALL31,1236,6/17/22
12173,1,2,2,5,SCARE71,1242,6/17/22
12174,0,2,1,3,EPIC02,1321,6/17/22
12175,2,2,5,9,EPIC03,1324,6/17/22
12176,1,2,3,6,AMMO06,1336,6/17/22
12177,2,2,4,8,FURY05,1333,6/17/22
12178,1,2,3,6,SHINR81,1327,6/17/22
12179,1,2,2,5,SHINR82,1330,6/17/22
12180,2,2,0,4,CREEP31,1335,6/17/22
12181,2,2,1,5,CREEP32,1338,6/17/22
12182,0,2,2,4,DRAGN76,1345,6/17/22
12183,1,2,3,6,RENO71,1351,6/17/22
12184,1,2,2,5,RENO72,1354,6/17/22
12185,1,1,2,4,RECON82,1357,6/17/22
12186,0,2,3,5,RECON69,1400,6/17/22
12187,0,1,4,5,DRAGN71,1348,6/17/22
12188,1,2,4,7,DRAGN53,1412,6/17/22
12189,2,2,3,7,TORA61,1403,6/17/22
12190,2,2,6,10,TORA62,1406,6/17/22
12191,4,2,1,7,SMALL62,1418,6/17/22
12192,1,2,3,6,DRAGN55,1415,6/17/22
12193,0,2,3,5,DRAGN51,1424,6/17/22
12194,2,2,1,5,BALL42,1521,6/17/22
12195,1,2,2,5,VEGA21,1421,6/17/22
12196,1,2,5,8,VEGA22,1424,6/17/22
12197,2,2,3,7,HOOK94,1427,6/17/22
12198,1,3,2,6,WIRE31,1500,6/17/22
12199,1,3,5,9,WIRE32,1503,6/17/22
12200,0,2,3,5,HOOK41,1515,6/17/22
12201,0,1,0,1,PAWS48,1518,6/17/22
12202,1,2,3,6,TORA31,1509,6/17/22
12203,1,2,3,6,TORA32,1512,6/17/22
12204,2,2,2,6,HOOK75,1600,6/17/22
12205,0,2,4,6,DRAGN41,800,6/21/22
12206,0,2,5,7,DRAGN42,803,6/21/22
12207,0,4,5,9,HOOK48,809,6/21/22
12208,0,0,5,5,DRAGN 55,818,6/21/22
12209,0,2,4,6,HOOK05,806,6/21/22
12210,0,0,5,5,DRAGN51,812,6/21/22
12211,3,1,5,9,DRAGN53,815,6/21/22
12212,1,1,3,5,CRAZE42,827,6/21/22
12213,1,2,6,9,HOOK59,821,6/21/22
12214,2,1,3,6,ETCH41,830,6/21/22
12215,2,2,3,7,ETCH42,830,6/21/22
12216,1,1,2,4,AXLE11,839,6/21/22
12217,1,1,1,3,AXLE12,839,6/21/22
12218,1,4,2,7,HANG51,845,6/21/22
12219,1,4,4,9,HANG52,845,6/21/22
12220,0,0,0,0,AMMO09,830,6/21/22
12221,0,1,4,5,DRAGN32,851,6/21/22
12222,1,0,2,3,WIRE31,854,6/21/22
12223,1,0,1,2,WIRE32,854,6/21/22
12224,1,1,1,3,RECON81,915,6/21/22
12225,2,3,4,9,BALL18,909,6/21/22
12226,1,4,1,6,RENO71,903,6/21/22
12227,1,4,4,9,RENO72,903,6/21/22
12228,2,2,0,4,RECON04,921,6/21/22
12229,2,2,0,4,HOOK99,900,6/21/22
12230,1,3,4,8,BALL82,912,6/21/22
12231,2,1,2,5,RECON71,924,6/21/22
12232,0,4,1,5,BALL35,930,6/21/22
12233,1,1,1,3,SPECK69,933,6/21/22
12234,1,5,2,8,SHINR81,936,6/21/22
12235,1,5,1,7,SHINR82,936,6/21/22
12236,0,3,0,3,BALL31,927,6/21/22
12237,1,2,1,4,RECON99,948,6/21/22
12238,1,1,2,4,AMMO07,942,6/21/22
12239,3,4,2,9,VEGA21,957,6/21/22
12240,2,4,0,6,VEGA22,957,6/21/22
12241,3,1,4,8,RECON03,951,6/21/22
12242,2,1,0,3,BALL21,954,6/21/22
12243,3,2,1,6,SMALL32,1006,6/21/22
12244,3,4,0,7,SMALL33,1009,6/21/22
12245,1,3,1,5,BALL88,1012,6/21/22
12246,0,2,2,4,HOOK94,1021,6/21/22
12247,4,2,3,9,PAWS88,1027,6/21/22
12248,4,5,5,14,TORA71,1027,6/21/22
12249,1,5,3,9,TORA72,1027,6/21/22
12250,1,2,2,5,TAUNT11,1015,6/21/22
12251,1,2,2,5,TAUNT12,1015,6/21/22
12252,0,4,1,5,SLOW31,1115,6/21/22
12253,0,4,3,7,SLOW32,1115,6/21/22
12254,1,5,1,7,LOST11,1121,6/21/22
12255,1,5,3,9,LOST12,1124,6/21/22
12256,3,5,3,11,BALL16,1127,6/21/22
12257,2,2,1,5,SCARE72,1142,6/21/22
12258,0,5,2,7,PHNTM50,1130,6/21/22
12259,2,4,1,7,DAWG08,1133,6/21/22
12260,2,5,5,12,BALL08,1136,6/21/22
12261,1,5,3,9,BALL41,1139,6/21/22
12262,0,5,6,11,PHNTM55,1151,6/21/22
12263,2,5,5,12,DRAGN71,1154,6/21/22
12264,1,3,5,9,DRAGN51,1157,6/21/22
12265,1,4,6,11,DRAGN55,1203,6/21/22
12266,0,4,3,7,VEGA21,1209,6/21/22
12267,0,4,6,10,VEGA22,1212,6/21/22
12268,0,4,2,6,HOOK69,1206,6/21/22
12269,1,2,4,7,WIRE31,1221,6/21/22
12270,1,2,6,9,WIRE32,1224,6/21/22
12271,2,4,4,10,DRAGN99,1239,6/21/22
12272,0,4,1,5,HOOK22,1236,6/21/22
12273,5,6,2,13,BALL13,1245,6/21/22
12274,0,0,1,1,DRAGN26,1233,6/21/22
12275,2,5,4,11,BADGER01,1312,6/21/22
12276,2,3,3,8,BALL31,1306,6/21/22
12277,2,2,0,4,PAWS41,1300,6/21/22
12278,0,4,0,4,COBRA08,1303,6/21/22
12279,1,3,1,5,BALL35,1309,6/21/22
12280,0,4,6,10,RECON03,1242,6/21/22
12281,2,5,6,13,OUZO71,1315,6/21/22
12282,2,5,1,8,OUZO72,1318,6/21/22
12283,2,4,6,12,EVIL01,1324,6/21/22
12284,1,4,2,7,HOOK62,1327,6/21/22
12285,3,3,1,7,BALL02,1321,6/21/22
12286,0,5,3,8,BALL58,1445,6/21/22
12287,2,6,2,10,RECON85,1448,6/21/22
12288,1,5,5,11,POST61,1457,6/21/22
12289,1,5,2,8,POST62,1500,6/21/22
12290,1,5,2,8,FURY05,1503,6/21/22
12291,1,5,1,7,EPIC02,1506,6/21/22
12292,1,4,1,6,AMMO09,1509,6/21/22
12293,1,5,1,7,BALL22,1512,6/21/22
12294,1,4,3,8,SCARE72,1527,6/21/22
12295,0,2,3,5,BALL48,1530,6/21/22
12296,4,4,1,9,VEGA21,0,6/21/22
12297,0,4,1,5,VEGA22,1530,6/21/22
12298,3,5,0,8,SMALL13,1521,6/21/22
12299,1,4,1,6,EVIL03,1530,6/21/22
12300,0,4,8,12,BUBO32,1536,6/21/22
12301,1,3,3,7,SPOT91,1542,6/21/22
12302,1,3,1,5,SPOT92,1545,6/21/22
12303,4,3,2,9,SMALL14,1524,6/21/22
12304,1,2,8,11,DRAGN48,1533,6/21/22
12305,3,3,3,9,SMALL25,1551,6/21/22
12306,4,3,4,11,SMALL26,1554,6/21/22
12307,5,3,2,10,SMALL24,1548,6/21/22
12308,4,3,5,12,SMALL22,1542,6/21/22
12309,1,5,3,9,RENO71,1603,6/21/22
12310,1,5,5,11,RENO72,1606,6/21/22
12311,1,4,0,5,STAB11,1552,6/21/22
12312,1,4,3,8,STAB12,1600,6/21/22
12313,1,2,3,6,SHINR81,1615,6/21/22
12314,1,2,2,5,SHINR82,1615,6/21/22
12315,1,6,6,13,WIRE31,1609,6/21/22
12316,1,6,7,14,WIRE32,1612,6/21/22
12317,1,2,5,8,HANG51,1621,6/21/22
12318,1,2,1,4,HANG22,1624,6/21/22
12319,0,2,2,4,CRAZE41,1633,6/21/22
12320,1,4,2,7,BALL36,1636,6/21/22
12321,0,2,2,4,COBRA01,1642,6/21/22
12322,1,2,3,6,BALL35,1639,6/21/22
12323,0,2,4,6,GIZMO11,1827,6/21/22
12324,0,2,1,3,GIZMO12,1830,6/21/22
12325,2,3,1,6,EPIC02,1821,6/21/22
12326,2,2,4,8,FURY05,1833,6/21/22
12327,2,3,8,13,RECON08,1900,6/21/22
12328,1,2,2,5,HOOK68,2024,6/21/22
12329,0,2,4,6,HOOK59,827,6/22/22
12330,2,2,4,8,RECON03,830,6/22/22
12331,1,1,5,7,VEGA21,833,6/22/22
12332,1,1,4,6,EVIL01,803,6/22/22
12333,0,1,4,5,HOOK41,806,6/22/22
12334,1,1,5,7,STAB11,809,6/22/22
12335,0,0,5,5,DRAGN55,824,6/22/22
12336,1,1,6,8,RENO71,842,6/22/22
12337,3,1,5,9,SCARE38,815,6/22/22
12338,2,0,6,8,DRAGN42,800,6/22/22
12339,1,1,3,5,DRAGN33,818,6/22/22
12340,0,0,6,6,HOOK37,851,6/22/22
12341,1,0,5,6,DRAGN53,821,6/22/22
12342,0,1,4,5,DRAGN34,848,6/22/22
12343,1,0,3,4,BALL88,909,6/22/22
12344,3,0,1,4,DRAGN05,915,6/22/22
12345,1,2,3,6,DRAGN96,912,6/22/22
12346,1,2,2,5,RECON82,906,6/22/22
12347,0,0,0,0,PHNTM14,900,6/22/22
12348,0,0,0,0,DRAGN22,903,6/22/22
12349,1,0,1,2,BALL17,918,6/22/22
12350,3,1,1,5,SMALL17,933,6/22/22
12351,0,1,0,1,COBRA01,930,6/22/22
12352,4,0,2,6,COACH21,921,6/22/22
12353,1,1,1,3,BALL38,933,6/22/22
12354,0,1,1,2,BALL36,939,6/22/22
12355,0,1,1,2,CRAZE46,936,6/22/22
12356,0,1,3,4,PAWS48,942,6/22/22
12357,2,2,2,6,RECON81,954,6/22/22
12358,1,1,1,3,BALL35,945,6/22/22
12359,4,1,2,7,SHINR81,948,6/22/22
12360,2,2,3,7,AMMO06,1000,6/22/22
12361,1,2,3,6,FURY01,957,6/22/22
12362,3,1,1,5,HOOK91,1015,6/22/22
12363,1,1,0,2,EASY42,1005,6/22/22
12364,1,1,2,4,LOST21,1021,6/22/22
12365,2,1,3,6,SLOW21,1039,6/22/22
12366,0,2,4,6,HOOK31,1030,6/22/22
12367,1,2,1,4,TORA31,1124,6/22/22
12368,2,2,1,5,TORA21,1140,6/22/22
12369,0,1,1,2,TORA23,1121,6/22/22
12370,2,0,2,4,TORA11,1133,6/22/22
12371,0,3,6,9,HOOK38,1027,6/22/22
12372,1,1,0,2,STAB11,1139,6/22/22
12373,2,2,2,6,RECON99,1130,6/22/22
12374,1,1,8,10,GOLEM61,1033,6/22/22
12375,4,0,2,6,SMALL73,1145,6/22/22
12376,3,1,1,5,BALL 48,1151,6/22/22
12377,0,2,2,4,HOOK69,1221,6/22/22
12378,2,0,4,6,BOBO32,1200,6/22/22
12379,1,2,5,8,BALL08,1148,6/22/22
12380,3,1,6,10,DRAGN42,1157,6/22/22
12381,2,1,6,9,DRAGN55,1212,6/22/22
12382,0,1,5,6,DRAGN51,1203,6/22/22
12383,3,2,3,8,SMALL11,1215,6/22/22
12384,3,1,3,7,DRAGN03,1218,6/22/22
12385,1,0,7,8,DRAGN 53,1215,6/22/22
12386,0,2,5,7,DRAGN33,1206,6/22/22
12387,4,1,2,7,SMALL14,1224,6/22/22
12388,4,2,1,7,RENO71,1230,6/22/22
12389,4,2,1,7,RENO72,1230,6/22/22
12390,1,2,7,10,WIRE31,1239,6/22/22
12391,3,0,0,3,SMALL24,1248,6/22/22
12392,2,2,1,5,PAWS88,1236,6/22/22
12393,1,3,1,5,HOOK22,1245,6/22/22
12394,1,0,2,3,COACH21,1251,6/22/22
12395,0,1,4,5,COBRA08,1306,6/22/22
12396,0,2,2,4,COBRA05,1300,6/22/22
12397,1,1,1,3,BALL19,1303,6/22/22
12398,3,1,6,10,BALL18,1257,6/22/22
12399,3,0,1,4,SMALL35,1315,6/22/22
12400,0,0,2,2,PAWS46,1309,6/22/22
12401,2,1,5,8,PAWS41,1312,6/22/22
12402,1,2,1,4,BALL88,1324,6/22/22
12403,3,1,4,8,CREEP31,1318,6/22/22
12404,3,1,4,8,CREEP32,1321,6/22/22
12405,0,0,2,2,PAWS11,1330,6/22/22
12406,2,1,0,3,BALL02,1327,6/22/22
12407,0,5,3,8,BALL52,1442,6/22/22
12408,2,1,3,6,EPIC03,1454,6/22/22
12409,2,2,6,10,RECON03,1506,6/22/22
12410,4,2,1,7,POST61,1500,6/22/22
12411,4,2,1,7,POST62,1503,6/22/22
12412,0,3,5,8,BALL24,1512,6/22/22
12413,4,2,2,8,SHINR81,1448,6/22/22
12414,2,2,6,10,FURY05,1503,6/22/22
12415,2,2,3,7,COBRA01,1527,6/22/22
12416,2,1,2,5,TAUNT11,1509,6/22/22
12417,1,3,3,7,CREEP31,1518,6/22/22
12418,0,2,7,9,RECON08,1524,6/22/22
12419,3,1,0,4,SMALL17,1533,6/22/22
12420,0,2,0,2,RECON04,1530,6/22/22
12421,1,2,1,4,SCARE72,1539,6/22/22
12422,0,3,1,4,BALL41,1536,6/22/22
12423,3,5,6,14,TORA11,1545,6/22/22
12424,3,5,6,14,TORA12,1548,6/22/22
12425,1,2,4,7,DRAGN05,1551,6/22/22
12426,0,2,1,3,LOOT55,1554,6/22/22
12427,1,1,3,5,DRAGN33,1606,6/22/22
12428,1,1,3,5,RECON01,1542,6/22/22
12429,0,2,0,2,HOOK68,1615,6/22/22
12430,1,1,1,3,DRAGN72,1609,6/22/22
12431,1,2,1,4,RENO71,1618,6/22/22
12432,1,2,2,5,RENO72,1621,6/22/22
12433,3,1,0,4,SMALL43,1633,6/22/22
12434,1,2,4,7,WIRE31,1024,6/22/22
12435,4,2,3,9,WIRE32,1627,6/22/22
12436,1,2,1,4,HANG51,1636,6/22/22
12437,1,2,2,5,HANG52,1639,6/22/22
12438,0,4,4,8,Ammo06,1848,6/22/22
12439,2,4,3,9,Epic09,1839,6/22/22
12440,2,3,4,9,BALL 65,1851,6/22/22
12441,0,5,2,7,EPIC 03,1842,6/22/22
12442,2,3,3,8,BALL 41,2024,6/22/22
12443,2,2,1,5,BALL 42,2030,6/22/22
12444,1,0,4,5,DRAGN 41,803,6/23/22
12445,1,0,7,8,Dragn 42,806,6/23/22
12446,0,2,3,5,HOOK 59,812,6/23/22
12447,1,0,7,8,SCARE 18,830,6/23/22
12448,0,2,7,9,DRAGN 53,818,6/23/22
12449,0,0,4,4,DRAGN 55,821,6/23/22
12450,1,2,3,6,CRAZE 42,827,6/23/22
12451,0,1,6,7,DRAGN 33,815,6/23/22
12452,1,1,1,3,RENO71,839,6/23/22
12453,0,0,2,2,RENO72,842,6/23/22
12454,1,3,4,8,WIRE31,848,6/23/22
12455,1,3,4,8,WIRE32,851,6/23/22
12456,0,1,2,3,DRAGN76,833,6/23/22
12457,1,1,4,6,DRGN94,845,6/23/22
12458,1,1,1,3,AMMO07,906,6/23/22
12459,1,1,0,2,STAB  11,854,6/23/22
12460,1,1,2,4,STAB12,857,6/23/22
12461,1,3,0,4,DRGN99,912,6/23/22
12462,3,0,0,3,SMALL05,909,6/23/22
12463,1,2,2,5,BALL01,903,6/23/22
12464,2,2,1,5,CREEP31,918,6/23/22
12465,2,2,0,4,CREEP31,921,6/23/22
12466,1,2,2,5,PAWS48,924,6/23/22
12467,2,1,3,6,HOOK71,927,6/23/22
12468,1,1,1,3,Ball35,933,6/23/22
12469,1,2,2,5,SCARE72,939,6/23/22
12470,1,2,2,5,BALL31,939,6/23/22
12471,3,2,0,5,SMALL22,942,6/23/22
12472,1,1,1,3,SPECK69,936,6/23/22
12473,1,2,2,5,SHINR81,945,6/23/22
12474,4,2,2,8,SHINR81,948,6/23/22
12475,0,2,1,3,BALL21,1000,6/23/22
12476,1,3,2,6,AMMO06,954,6/23/22
12477,1,0,3,4,RECON82,957,6/23/22
12478,4,1,1,6,VEGA21,1009,6/23/22
12479,1,1,1,3,VEGA22,1012,6/23/22
12480,3,1,3,7,HOOK31,951,6/23/22
12481,0,2,1,3,BALL22,1003,6/23/22
12482,4,3,1,8,BALL02,1024,6/23/22
12483,3,1,2,6,PAWS44,1012,6/23/22
12484,1,3,1,5,LOST21,1015,6/23/22
12485,1,3,1,5,LOST22,1018,6/23/22
12486,1,0,6,7,HOOK37,1021,6/23/22
12487,2,1,1,4,GIZMO11,1027,6/23/22
12488,2,1,4,7,GIZMO12,1030,6/23/22
12489,1,1,0,2,GULEM61,1033,6/23/22
12490,1,1,4,6,GOLEM62,1036,6/23/22
12491,3,1,2,6,TORA71,1039,6/23/22
12492,3,1,2,6,TORA72,1042,6/23/22
12493,1,2,4,7,RECON04,1133,6/23/22
12494,0,1,0,1,PAWS76,1121,6/23/22
12495,2,2,1,5,BALL85,1118,6/23/22
12496,2,3,1,6,SLOW51,1124,6/23/22
12497,1,3,2,6,SLOW52,1127,6/23/22
12498,3,2,1,6,SMALL73,1145,6/23/22
12499,3,2,1,6,SMALL72,1142,6/23/22
12500,2,1,0,3,PAWS16,1136,6/23/22
12501,2,2,3,7,BALL 62,1130,6/23/22
12502,1,2,2,5,SCARE 77,1157,6/23/22
12503,1,2,1,4,RECON 99,1154,6/23/22
12504,1,2,3,6,BALL 08,1148,6/23/22
12505,0,2,2,4,EVIL 18,1151,6/23/22
12506,2,1,4,7,POST 61,1200,6/23/22
12507,1,1,3,5,POST 62,1203,6/23/22
12508,3,2,4,9,SMALL 06,1206,6/23/22
12509,4,1,4,9,SMALL 85,1224,6/23/22
12510,3,2,5,10,CRAZE 42,1221,6/23/22
12511,2,2,4,8,DRAGN 55,1218,6/23/22
12512,1,3,3,7,RENO 71,1236,6/23/22
12513,1,3,0,4,RENO 72,1239,6/23/22
12514,1,2,4,7,HOOK 33,1212,6/23/22
12515,1,2,4,7,WIRE 31,1227,6/23/22
12516,1,2,6,9,WIRE 32,1230,6/23/22
12517,0,1,5,6,DRAGN 53,1215,6/23/22
12518,2,3,4,9,AXLE 11,1245,6/23/22
12519,2,3,5,10,AXLE 12,1248,6/23/22
12520,1,2,4,7,STAB 11,1254,6/23/22
12521,1,2,3,6,STAB 12,1257,6/23/22
12522,2,1,5,8,DRAGN 71,1242,6/23/22
12523,0,2,6,8,HOOK 31,1251,6/23/22
12524,2,3,1,6,GIZMO 31,1303,6/23/22
12525,2,3,3,8,GIZMO 32,1306,6/23/22
12526,3,4,3,10,BALL 18,1300,6/23/22
12527,0,1,3,4,PAWS 48,1309,6/23/22
12528,0,3,2,5,COBRA 01,1315,6/23/22
12529,2,3,1,6,OUZ0 71,1318,6/23/22
12530,3,3,2,8,OUZO 72,1321,6/23/22
12531,1,2,2,5,SCARE 78,1312,6/23/22
12532,0,2,3,5,DRAGN 59,1324,6/23/22
12533,1,3,5,9,RECON 82,1448,6/23/22
12534,2,3,3,8,FURY 05,1445,6/23/22
12535,1,3,1,5,RECON 04,1451,6/23/22
12536,1,3,3,7,EPIC 03,1442,6/23/22
12537,2,2,3,7,CRAZE 14,1503,6/23/22
12538,1,3,1,5,BALL 38,1454,6/23/22
12539,0,3,2,5,BALL 52,1506,6/23/22
12540,4,3,3,10,BALL 02,1457,6/23/22
12541,0,1,4,5,AMMO 07,1500,6/23/22
12542,1,3,5,9,AXLE 11,1512,6/23/22
12543,1,3,2,6,AXLE 12,1515,6/23/22
12544,1,2,3,6,FURY 02,1509,6/23/22
12545,0,3,4,7,BALL 24,1527,6/23/22
12546,0,3,3,6,BALL 21,1524,6/23/22
12547,1,2,4,7,VEGA 21,1518,6/23/22
12548,1,2,2,5,VEGA 22,1521,6/23/22
12549,1,3,5,9,STAB 11,1518,6/23/22
12550,1,3,1,5,STAB 12,1521,6/23/22
12551,1,3,2,6,BALL 42,1536,6/23/22
12552,0,3,5,8,SMALL 23,1545,6/23/22
12553,0,2,4,6,DAWG 08,1542,6/23/22
12554,0,3,2,5,BALL 19,1539,6/23/22
12555,1,3,1,5,SCARE 01,1548,6/23/22
12556,0,2,1,3,DRAGN 96,1600,6/23/22
12557,1,2,5,8,POST 61,1554,6/23/22
12558,2,2,5,9,POST 62,1557,6/23/22
12559,0,3,7,10,PHTNM 55,1551,6/23/22
12560,1,3,7,11,DRAGN 53,1606,6/23/22
12561,1,1,7,9,DRAGN 33,1603,6/23/22
12562,1,4,3,8,HOOK 68,1609,6/23/22
12563,0,2,3,5,HOOK99,1633,6/23/22
12564,3,2,2,7,SMALL44,1636,6/23/22
12565,1,1,4,6,WIRE31,1621,6/23/22
12566,1,1,3,5,WIRE32,1621,6/23/22
12567,1,3,2,6,HANG51,1615,6/23/22
12568,4,3,2,9,HANG52,1618,6/23/22
12569,1,3,2,6,HOOK66,1639,6/23/22
12570,1,1,1,3,CREEP31,1830,6/23/22
12571,1,1,2,4,CREEP32,1833,6/23/22
12572,2,3,3,8,FILL31,1821,6/23/22
12573,2,3,3,8,FILL32,1824,6/23/22
12574,1,2,2,5,BALL08,1827,6/23/22
12575,2,3,3,8,EPIC08,1839,6/23/22
12576,1,1,6,8,FT4005,1845,6/23/22
12577,0,2,7,9,DRAGN41,800,6/24/22
12578,1,3,0,4,EASY86,801,6/24/22
12579,1,2,4,7,DRAGN42,806,6/24/22
12580,1,5,1,7,EASY42,802,6/24/22
12581,0,4,4,8,DRAGN53,809,6/24/22
12582,3,4,7,14,BUBO32,803,6/24/22
12583,3,0,2,5,SMALL62,818,6/24/22
12584,0,1,5,6,DRAGN55,812,6/24/22
12585,1,4,1,6,RENO71,827,6/24/22
12586,1,4,3,8,RENO72,830,6/24/22
12587,1,3,5,9,CREEP31,839,6/24/22
12588,1,3,5,9,CREEP32,842,6/24/22
12589,2,5,7,14,SHINR81,833,6/24/22
12590,2,5,5,12,SHINR82,836,6/24/22
12591,3,4,3,10,SMALL61,815,6/24/22
12592,2,1,3,6,BADGR01,854,6/24/22
12593,1,1,2,4,BALL88,906,6/24/22
12594,1,3,2,6,RECON78,857,6/24/22
12595,3,1,2,6,PAWS48,900,6/24/22
12596,4,1,6,11,SMALL12,918,6/24/22
12597,1,3,1,5,POST61,904,6/24/22
12598,1,5,3,9,BALL01,0,6/24/22
12599,0,2,1,3,BALL19,939,6/24/22
12600,1,1,1,3,SCARE72,924,6/24/22
12601,1,2,3,6,RECON03,933,6/24/22
12602,1,1,2,4,AXLE11,927,6/24/22
12603,1,1,0,2,AXLE12,930,6/24/22
12604,0,2,2,4,BALL99,921,6/24/22
12605,1,1,3,5,EPIC03,936,6/24/22
12606,1,1,1,3,COACH21,948,6/24/22
12607,1,1,3,5,COACH22,951,6/24/22
12608,1,3,0,4,STAB11,957,6/24/22
12609,1,3,0,4,STAB12,1000,6/24/22
12610,1,1,2,4,SLOW11,0,6/24/22
12611,0,1,0,1,SLOW12,0,6/24/22
12612,1,1,2,4,LOST21,1021,6/24/22
12613,1,1,3,5,LOST22,1024,6/24/22
12614,2,3,3,8,GIZMO41,1039,6/24/22
12615,2,3,0,5,GIZMO42,1042,6/24/22
12616,1,5,2,8,EASY42,1035,6/24/22
12617,1,2,0,3,GIZMO11,1027,6/24/22
12618,1,2,0,3,GIZMO12,1030,6/24/22
12619,0,3,1,4,FURY05,1127,6/24/22
12620,1,3,0,4,TORA21,1118,6/24/22
12621,1,3,2,6,TORA22,1121,6/24/22
12622,0,5,0,5,BALL17,1115,6/24/22
12623,1,3,1,5,FURY02,1124,6/24/22
12624,0,3,2,5,AMMO09,1133,6/24/22
12625,0,3,1,4,BALL66,1130,6/24/22
12626,1,2,5,8,HANG51,1136,6/24/22
12627,1,2,5,8,HANG52,1139,6/24/22
12628,2,3,4,9,HOOK41,1145,6/24/22
12629,0,2,2,4,Hook51,1154,6/24/22
12630,2,2,7,11,Dragon53,1148,6/24/22
12631,5,0,3,8,small72,1142,6/24/22
12632,2,2,8,12,Dragn,1151,6/24/22
12633,3,3,2,8,Small04,1200,6/24/22
12634,4,1,2,7,Small05,1203,6/24/22
12635,1,3,0,4,Vega21,1206,6/24/22
12636,1,3,1,5,Vega22,1209,6/24/22
12637,1,4,2,7,Reno71,1212,6/24/22
12638,4,4,1,9,Reno72,1215,6/24/22
12639,0,2,2,4,Hook66,1300,6/24/22
12640,2,2,5,9,DRAGN59,1236,6/24/22
12641,2,1,1,4,Evil03,1230,6/24/22
12642,1,2,7,10,shinr81,1227,6/24/22
12643,1,2,3,6,shinr82,1230,6/24/22
12644,0,1,2,3,Paws69,1233,6/24/22
12645,0,2,2,4,Ball42,1254,6/24/22
12646,2,3,3,8,EPIC08,1309,6/24/22
12647,0,3,1,4,speck69,1300,6/24/22
12648,0,3,2,5,Ball99,1303,6/24/22
12649,1,5,0,6,Craze14,1306,6/24/22
12650,3,3,1,7,Recon04,1312,6/24/22
12651,0,1,2,3,POST61,1324,6/24/22
12652,1,5,0,6,CRAZE44,1330,6/24/22
12653,2,6,2,10,ball61,1439,6/24/22
12654,1,3,2,6,FURY02,1445,6/24/22
12655,1,4,4,9,FURY05,1448,6/24/22
12656,0,2,6,8,HOOK37,0,6/24/22
12657,1,6,6,13,RECON03,1451,6/24/22
12658,2,4,2,8,CREEP31,1457,6/24/22
12659,2,4,0,6,CREEP32,1500,6/24/22
12660,1,6,3,10,STAB11,1506,6/24/22
12661,1,6,0,7,STAB12,1509,6/24/22
12662,3,3,3,9,TAUNT21,1430,6/24/22
12663,3,3,2,8,TAUNT22,1433,6/24/22
12664,1,5,3,9,AXLE11,1521,6/24/22
12665,1,5,1,7,AXLE12,1524,6/24/22
12666,2,3,2,7,HOOK75,1512,6/24/22
12667,1,4,4,9,HANG51,1551,6/24/22
12668,1,4,4,9,HANG52,1554,6/24/22
12669,0,7,4,11,HOOK66,1557,6/24/22
12670,1,7,1,9,MANLY21,1536,6/24/22
12671,1,7,2,10,MANLY22,1539,6/24/22
12672,2,1,3,6,HOOK51,1524,6/24/22
12673,1,6,1,8,RENO71,1615,6/24/22
12674,4,6,1,11,RENO72,1618,6/24/22
12675,2,3,2,7,HOOK01,1612,6/24/22
12676,0,7,1,8,LOOT14,1633,6/24/22
12677,2,5,0,7,HOOK61,1630,6/24/22
12678,2,6,4,12,EPIC08,1613,6/24/22
12679,1,6,0,7,MANLY99,1609,6/24/22
12680,2,3,7,12,HOOK33,1527,6/24/22
12681,3,4,0,7,MANLY68,1642,6/24/22
12682,3,4,2,9,MANLY69,1645,6/24/22
12683,0,3,3,6,BALL78,1648,6/24/22
12684,1,2,0,3,EVIL18,1821,6/24/22
12685,2,5,3,10,BALL08,1818,6/24/22
12686,1,6,2,9,GIZMO71,1839,6/24/22
12687,1,6,1,8,GIZMO72,1842,6/24/22
12688,1,5,2,8,BALL22,1830,6/24/22
12689,0,4,0,4,BALL41,1815,6/24/22
12690,0,5,1,6,BALL36,1854,6/24/22
12691,3,3,1,7,BALL35,1857,6/24/22
12692,0,5,1,6,BALL38,1851,6/24/22
12693,2,1,2,5,Rhino99,830,6/27/22
12694,2,1,3,6,Dragn76,839,6/27/22
12695,1,0,3,4,wire31,857,6/27/22
12696,1,0,2,3,wire32,857,6/27/22
12697,1,1,2,4,reno71,842,6/27/22
12698,1,1,7,9,reno72,845,6/27/22
12699,1,2,4,7,hang51,833,6/27/22
12700,1,2,4,7,hang52,836,6/27/22
12701,1,1,3,5,axle11,848,6/27/22
12702,1,1,2,4,axle12,851,6/27/22
12703,0,3,0,3,ball04,1206,6/26/22
12704,1,4,5,10,taunt11,1200,6/26/22
12705,1,4,1,6,taunt12,1200,6/27/22
12706,1,2,2,5,lost21,1230,6/26/22
12707,1,2,1,4,lost22,1233,6/26/22
12708,2,5,2,9,fill21,1200,6/26/22
12709,2,5,1,8,fill22,1200,6/26/22
12710,1,4,0,5,manly11,1224,6/26/22
12711,1,4,2,7,manly12,1230,6/26/22
12712,0,7,4,11,dragn71,1221,6/26/22
12713,1,4,4,9,creep31,1530,6/26/22
12714,1,4,3,8,creep32,1533,6/26/22
12715,0,4,1,5,dragn68,1557,6/26/22
12716,0,4,3,7,ball04,1536,6/26/22
12717,2,2,3,7,gizmo61,1239,6/26/22
12718,2,2,3,7,gizmo62,1241,6/26/22
12719,2,4,1,7,tora21,1624,6/26/22
12720,2,4,4,10,tora22,1624,6/26/22
12721,0,6,6,12,hook71,1551,6/26/22
12722,0,0,3,3,craze88,930,6/27/22
12723,1,1,2,4,recon04,909,6/27/22
12724,1,3,0,4,ball82,912,6/27/22
12725,0,2,0,2,dragn42,927,6/27/22
12726,1,0,3,4,post61,933,6/27/22
12727,1,0,3,4,post62,933,6/27/22
12728,1,0,2,3,craze55,918,6/27/22
12729,0,1,1,2,craze42,948,6/27/22
12730,0,1,3,4,dragon53,942,6/27/22
12731,0,0,2,2,dragn51,939,6/27/22
12732,1,1,0,2,craze11,915,6/27/22
12733,3,0,2,5,Small25,951,6/27/22
12734,3,0,0,3,small23,945,6/27/22
12735,1,1,2,4,recon81,954,6/27/22
12736,2,0,1,3,fury01,1000,6/27/22
12737,1,3,2,6,epic08,1009,6/27/22
12738,2,1,3,6,lost21,1000,6/27/22
12739,2,1,6,9,lost22,1000,6/27/22
12740,1,0,1,2,fury02,957,6/27/22
12741,0,1,3,4,ball51,1006,6/27/22
12742,1,0,0,1,craze14,1012,6/27/22
12743,1,1,1,3,creep31,1021,6/27/22
12744,1,1,3,5,creep32,1024,6/27/22
12745,1,3,0,4,stab11,1027,6/27/22
12746,1,3,0,4,stab12,1027,6/27/22
12747,0,1,2,3,ball03,1027,6/27/22
12748,0,1,3,4,dawg01,1036,6/27/22
12749,0,1,1,2,ball42,1030,6/27/22
12750,0,1,2,3,ball01,1036,6/27/22
12751,2,1,3,6,hook99,1054,6/27/22
12752,0,1,3,4,hook22,1051,6/27/22
12753,1,3,3,7,tora31,1130,6/27/22
12754,1,3,1,5,tora32,1130,6/27/22
12755,1,4,0,5,taunt11,1139,6/27/22
12756,1,4,1,6,taunt12,1142,6/27/22
12757,1,3,3,7,tora21,1145,6/27/22
12758,1,3,0,4,tora22,1148,6/27/22
12759,1,3,2,6,fury05,1151,6/27/22
12760,3,2,1,6,ball08,1154,6/27/22
12761,2,1,4,7,dragn73,1224,6/27/22
12762,1,1,1,3,evil10,1221,6/27/22
12763,1,1,2,4,axle11,1230,6/27/22
12764,1,1,4,6,axle12,1233,6/27/22
12765,1,0,6,7,dragn75,1218,6/27/22
12766,1,1,4,6,dragn62,1227,6/27/22
12767,2,3,3,8,craze43,1251,6/27/22
12768,2,0,5,7,dragn31,1245,6/27/22
12769,0,4,3,7,dragn51,1312,6/27/22
12770,0,2,4,6,paws69,1257,6/27/22
12771,0,0,1,1,paws11,1254,6/27/22
12772,0,5,2,7,dragn42,1303,6/27/22
12773,1,0,4,5,shinr81,1306,6/27/22
12774,1,0,4,5,shinr82,1309,6/27/22
12775,0,2,3,5,craze42,1324,6/27/22
12776,1,1,4,6,dragn53,1315,6/27/22
12777,2,1,1,4,dragn59,1318,6/27/22
12778,2,2,2,6,paws88,1300,6/27/22
12779,1,3,2,6,recon99,1330,6/27/22
12780,0,2,2,4,fury06,1327,6/27/22
12781,1,3,2,6,Vega21,1345,6/27/22
12782,4,3,4,11,vega22,1345,6/27/22
12783,1,3,2,6,fury01,1333,6/27/22
12784,2,2,2,6,HOOK19,1454,6/27/22
12785,1,3,1,5,GIZMO31,1432,6/27/22
12786,1,3,0,4,GIZMO32,1435,6/27/22
12787,1,4,2,7,EPIC08,1500,6/27/22
12788,2,3,3,8,RECON04,1503,6/27/22
12789,1,4,4,9,BALL51,1457,6/27/22
12790,0,1,1,2,DRAGN05,1518,6/27/22
12791,0,1,5,6,EVIL03,1521,6/27/22
12792,2,0,3,5,SMALL16,1530,6/27/22
12793,1,4,2,7,STAB11,1524,6/27/22
12794,4,4,1,9,STAB12,1527,6/27/22
12795,0,1,5,6,LOOT08,1542,6/27/22
12796,0,2,7,9,DAWG01,1536,6/27/22
12797,2,1,2,5,BALL48,1533,6/27/22
12798,0,1,4,5,BALL42,1539,6/27/22
12799,2,0,3,5,WIRE31,1545,6/27/22
12800,2,0,2,4,WIRE32,1548,6/27/22
12801,0,3,2,5,COBRA06,1551,6/27/22
12802,0,3,4,7,DRAGN71,1554,6/27/22
12803,0,4,4,8,DRAGN76,1557,6/27/22
12804,1,0,0,1,AXLE11,1618,6/27/22
12805,1,0,3,4,AXLE12,1621,6/27/22
12806,2,3,4,9,GOLEM41,1600,6/27/22
12807,2,3,1,6,GOLEM42,1600,6/27/22
12808,1,2,6,9,HOOK38,1624,6/27/22
12809,3,1,1,5,SMALL41,1627,6/27/22
12810,0,2,4,6,DRAGN55,1648,6/27/22
12811,1,1,2,4,VEGA21,1630,6/27/22
12812,1,1,6,8,VEGA22,1654,6/27/22
12813,0,4,4,8,DRAGN33,1645,6/27/22
12814,0,2,1,3,PAWS76,1739,6/27/22
12815,1,2,2,5,AMMO06,1757,6/27/22
12816,1,4,3,8,FURY06,1800,6/27/22
12817,0,3,7,10,BALL41,1900,6/27/22
12818,1,2,2,5,EPIC03,1857,6/27/22
12819,1,3,3,7,EPIC09,1900,6/27/22
12820,2,3,2,7,RECON99,1906,6/27/22
12821,0,1,3,4,DAWG08,1903,6/27/22
12822,0,0,0,0,Ball35,0,6/27/22
12823,1,1,3,5,BALL35,2052,6/27/22
12824,1,2,4,7,HOOK55,2106,6/27/22
12825,2,1,5,8,ammo08,2048,6/27/22
12826,1,1,3,5,Hook33,2103,6/27/22
12827,2,1,1,4,RECON05,2045,6/27/22
12828,2,3,1,6,Ball21,2109,6/27/22
12829,2,1,2,5,Ball16,2100,6/27/22
12830,1,2,4,7,Hook26,2112,6/27/22
12831,1,2,4,7,loot14,2115,6/27/22
12832,2,1,5,8,DRAGON 62,845,6/28/22
12833,1,2,2,5,Axle 11,839,6/28/22
12834,1,2,1,4,Axle 12,839,6/28/22
12835,1,1,4,6,Scare 36,848,6/28/22
12836,2,1,5,8,Dragon 71,836,6/28/22
12837,1,0,2,3,Hang 51,830,6/28/22
12838,4,0,1,5,Hang 52,830,6/28/22
12839,1,1,6,8,SHINR81,903,6/28/22
12840,1,1,5,7,SHINR82,903,6/28/22
12841,1,2,2,5,BALL88,851,6/28/22
12842,2,0,2,4,BALL82,854,6/28/22
12843,1,0,2,3,WIRE 31,909,6/28/22
12844,4,0,1,5,WIRE 32,909,6/28/22
12845,0,4,0,4,DRAGN01,900,6/28/22
12846,2,1,0,3,CRAZE42,936,6/28/22
12847,3,0,2,5,SMALL 13,921,6/28/22
12848,3,0,2,5,SMALL 17,933,6/28/22
12849,0,3,1,4,DRAGN51,927,6/28/22
12850,1,0,5,6,DRAGN48,924,6/28/22
12851,2,1,4,7,DRAGN 53,930,6/28/22
12852,2,1,6,9,GHOST02,948,6/28/22
12853,1,2,2,5,FURY01,951,6/28/22
12854,2,1,1,4,RECON01,1003,6/28/22
12855,0,3,4,7,BALL03,954,6/28/22
12856,1,4,2,7,BALL 66,942,6/28/22
12857,3,1,2,6,RECON04,945,6/28/22
12858,4,0,1,5,SMALL 27,957,6/28/22
12859,2,3,3,8,CRAZE 43,1000,6/28/22
12860,3,0,0,3,SMALL 34,1012,6/28/22
12861,1,3,4,8,STAB11,1015,6/28/22
12862,2,3,0,5,STAB12,1015,6/28/22
12863,1,2,2,5,LOOT 08,1021,6/28/22
12864,2,3,2,7,CRAZE 13,1024,6/28/22
12865,2,0,0,2,SMALL 41,1027,6/28/22
12866,2,0,1,3,SMALL 42,1030,6/28/22
12867,2,1,1,4,RECON 85,1009,6/28/22
12868,0,0,1,1,BALL 08,1033,6/28/22
12869,2,3,3,8,SLOW 61,1103,6/28/22
12870,1,3,0,4,SLOW 62,1106,6/28/22
12871,2,1,0,3,SLOW 81,1142,6/28/22
12872,1,1,1,3,SLOW 82,1145,6/28/22
12873,1,1,3,5,TAUNT11,1136,6/28/22
12874,1,1,1,3,TAUNT12,1136,6/28/22
12875,2,1,1,4,Vega 21,1224,6/28/22
12876,1,1,6,8,Vega 22,1224,6/28/22
12877,3,0,1,4,SMALL 78,1230,6/28/22
12878,2,1,2,5,DRAGN 76,1215,6/28/22
12879,0,3,3,6,PHNTM 55,1230,6/28/22
12880,1,1,5,7,SHINR 81,1236,6/28/22
12881,4,1,2,7,SHINR 82,1236,6/28/22
12882,1,1,3,5,WIRE 31,1242,6/28/22
12883,4,1,4,9,WIRE 32,1245,6/28/22
12884,2,1,7,10,DRAGN71,1218,6/28/22
12885,4,1,2,7,LOST 21,1048,6/28/22
12886,2,1,6,9,LOST 22,1051,6/28/22
12887,1,0,0,1,RENO 31,1254,6/28/22
12888,1,0,4,5,RENO 32,1257,6/28/22
12889,3,1,0,4,SMALL25,1251,6/28/22
12890,1,0,3,4,SCARE 99,1315,6/28/22
12891,1,0,1,2,HYDRA 31,1300,6/28/22
12892,1,0,3,4,HYDRA 32,1303,6/28/22
12893,2,0,3,5,DRAGN 51,1306,6/28/22
12894,0,1,6,7,DRAGN 53,1309,6/28/22
12895,1,0,3,4,DRAGN 38,1318,6/28/22
12896,1,1,4,6,RECON 03,1324,6/28/22
12897,2,0,2,4,DRAGN 59,1312,6/28/22
12898,1,0,1,2,AXLE 11,1327,6/28/22
12899,4,0,3,7,AXLE 12,1330,6/28/22
12900,3,1,2,6,PHNTM 48,1321,6/28/22
12901,1,2,2,5,EASY 42,1335,6/28/22
12902,0,1,3,4,RECON 82,1339,6/28/22
12903,0,1,1,2,HOOK 01,1345,6/28/22
12904,1,1,0,2,RECON85,1342,6/28/22
12905,0,0,2,2,HOOK03,1451,6/28/22
12906,4,0,0,4,SMALL74,1448,6/28/22
12907,0,1,3,4,EPIC03,1457,6/28/22
12908,2,1,1,4,DAWG08,1503,6/28/22
12909,0,1,0,1,CRAZE 14,1500,6/28/22
12910,2,0,2,4,COACH 21,1506,6/28/22
12911,2,0,2,4,COACH 22,1509,6/28/22
12912,3,0,0,3,SMALL 11,1515,6/28/22
12913,0,1,1,2,CRAZE 76,1512,6/28/22
12914,3,1,2,6,RECON 04,1530,6/28/22
12915,2,1,2,5,FILL 21,1524,6/28/22
12916,6,1,1,8,FILL 22,1527,6/28/22
12917,0,1,0,1,BALL 42,1539,6/28/22
12918,1,0,2,3,PAWS 13,1533,6/28/22
12919,1,1,3,5,SCARE 71,1542,6/28/22
12920,2,0,0,2,CREEP 31,1545,6/28/22
12921,2,0,2,4,CREEP 32,1548,6/28/22
12922,0,2,2,4,BALL 16,1551,6/28/22
12923,1,1,5,7,HANG 51,1615,6/28/22
12924,1,1,3,5,HANG 52,1618,6/28/22
12925,1,0,4,5,WIRE 31,1621,6/28/22
12926,1,0,6,7,WIRE 32,1624,6/28/22
12927,0,0,4,4,HOOK 37,1627,6/28/22
12928,2,1,8,11,ETCH 41,1630,6/28/22
12929,2,1,6,9,ETCH 42,1633,6/28/22
12930,0,1,4,5,DRAGN 33,1642,6/28/22
12931,1,1,7,9,DRAGN 55,1645,6/28/22
12932,1,0,1,2,VEGA 21,1636,6/28/22
12933,1,0,3,4,VEGA 22,1639,6/28/22
12934,1,1,1,3,TORA 71,1630,6/28/22
12935,1,1,2,4,TORA 72,1630,6/28/22
12936,1,1,4,6,AXLE 11,1054,6/28/22
12937,1,1,0,2,AXLE 12,1057,6/28/22
12938,1,0,0,1,GIZMO 31,1730,6/28/22
12939,1,0,0,1,GIZMO 32,1733,6/28/22
12940,2,1,1,4,EPIC 03,1833,6/28/22
12941,1,1,1,3,EPIC09,1836,6/28/22
12942,0,0,1,1,CREEP31,1845,6/28/22
12943,0,0,4,4,CREEP32,0,6/28/22
12944,0,1,7,8,BALL08,1906,6/28/22
12945,1,1,6,8,BALL48,1909,6/28/22
12946,2,0,3,5,HANG51,2050,6/28/22
12947,2,0,1,3,HANG52,2050,6/28/22
12948,2,1,4,7,BALL16,2057,6/28/22
12949,1,2,3,6,HOOK33,2103,6/28/22
12950,3,0,0,3,RECON99,2100,6/28/22
12951,2,0,0,2,BALL41,2109,6/28/22
12952,1,0,2,3,DRAGN42,2054,6/28/22
12953,1,1,7,9,HOOK55,2106,6/28/22
12954,1,0,4,5,CRAZE88,2112,6/28/22
12955,1,1,1,3,BADGR02,2118,6/28/22
12956,1,0,6,7,DRAGN99,2115,6/28/22
12957,4,0,6,10,Hang51,833,6/29/22
12958,1,0,3,4,Hang52,836,6/29/22
12959,3,1,5,9,DRAGN71,830,6/29/22
12960,1,1,2,4,BALL88,0,6/29/22
12961,1,1,3,5,WIRE31,839,6/29/22
12962,4,1,2,7,WIRE32,842,6/29/22
12963,2,0,1,3,DRAGN51,900,6/29/22
12964,3,0,0,3,SMALL73,845,6/29/22
12965,1,0,0,1,VEGA21,854,6/29/22
12966,1,0,0,1,VEGA22,854,6/29/22
12967,4,0,5,9,DRAGN53,903,6/29/22
12968,1,0,2,3,BALL82,915,6/29/22
12969,0,1,1,2,BALL85,918,6/29/22
12970,4,1,3,8,PHNTM48,933,6/29/22
12971,4,0,2,6,SMALL20,936,6/29/22
12972,4,0,2,6,SMALL78,936,6/29/22
12973,2,1,0,3,EPIC01,939,6/29/22
12974,1,0,2,3,CRAZE43,942,6/29/22
12975,3,0,0,3,RECON71,948,6/29/22
12976,2,0,1,3,STAB11,951,6/29/22
12977,1,0,1,2,STAB12,954,6/29/22
12978,3,0,1,4,SMALL27,957,6/29/22
12979,4,0,2,6,BADGER01,1015,6/29/22
12980,2,0,1,3,DAWG02,1000,6/29/22
12981,2,0,2,4,CRAZE13,1012,6/29/22
12982,2,0,1,3,SMALL31,1003,6/29/22
12983,1,2,2,5,PHNTM08,1009,6/29/22
12984,0,0,2,2,CRAZE41,1006,6/29/22
12985,0,1,5,6,BALL08,1021,6/29/22
12986,1,1,1,3,PAWS46,1018,6/29/22
12987,1,1,1,3,LOST21,1051,6/29/22
12988,1,1,1,3,LOST22,1054,6/29/22
12989,2,1,2,5,SLOW11,1103,6/29/22
12990,1,1,2,4,SLOW12,1100,6/29/22
12991,1,1,4,6,EIPC02,11420,6/29/22
12992,3,1,2,6,FURY05,1151,6/29/22
12993,1,1,1,3,EPIC09,1145,6/29/22
12994,0,1,3,4,BALL88,1154,6/29/22
12995,2,1,3,6,GIZMO61,1206,6/29/22
12996,2,1,11,14,GIZMO62,1209,6/29/22
12997,2,1,5,8,CREEP31,1200,6/29/22
12998,2,1,2,5,CREEP32,1203,6/29/22
12999,4,1,0,5,SMALL13,1221,6/29/22
13000,0,0,3,3,HOOK02,1212,6/29/22
13001,2,1,0,3,AXLE11,1215,6/29/22
13002,3,1,7,11,AXLE12,1218,6/29/22
13003,2,0,6,8,DRAGN51,1245,6/29/22
13004,1,0,1,2,VEGA21,1233,6/29/22
13005,1,0,8,9,VEGA22,1236,6/29/22
13006,1,0,0,1,RENO71,1239,6/29/22
13007,1,0,0,1,RENO72,1242,6/29/22
13008,2,0,0,2,TORA11,1136,6/29/22
13009,2,0,3,5,TORA12,1139,6/29/22
13010,1,2,0,3,SCARE21,1251,6/29/22
13011,1,1,0,2,DRAGN96,1254,6/29/22
13012,0,1,8,9,DRAGN53,1248,6/29/22
13013,2,0,2,4,SMALL32,1306,6/29/22
13014,2,2,3,7,CRAZE14,1309,6/29/22
13015,1,2,0,3,GIZMO21,1300,6/29/22
13016,1,2,2,5,GIZMO22,1303,6/29/22
13017,1,0,2,3,POST61,1300,6/29/22
13018,1,0,3,4,POST62,1303,6/29/22
13019,1,2,3,6,EPIC08,1312,6/29/22
13020,0,1,2,3,CRAZE76,1324,6/29/22
13021,1,1,3,5,COACH21,1318,6/29/22
13022,1,1,1,3,COACH22,1321,6/29/22
13023,3,1,2,6,SMALL41,1327,6/29/22
13024,1,2,5,8,RECON81,1342,6/29/22
13025,0,5,4,9,PAWS16,1333,6/29/22
13026,1,1,3,5,STAB11,1336,6/29/22
13027,1,1,3,5,STAB12,1339,6/29/22
13028,1,1,4,6,EVIL01,1330,6/29/22
13029,1,2,2,5,SCARE45,1348,6/29/22
13030,1,1,2,4,BALL85,1345,6/29/22
13031,1,2,0,3,EASY42,1400,6/29/22
13032,1,2,4,7,EIPC02,1442,6/29/22
13033,1,1,3,5,EIPC09,1445,6/29/22
13034,1,2,1,4,SHINR81,1448,6/29/22
13035,1,2,3,6,SHINR82,1451,6/29/22
13036,4,1,3,8,VEGA21,1457,6/29/22
13037,1,1,4,6,VEGA22,1500,6/29/22
13038,1,3,6,10,DAWG08,1509,6/29/22
13039,2,2,2,6,RECON99,1506,6/29/22
13040,1,2,3,6,DAWG01,1512,6/29/22
13041,1,2,2,5,CRAZE13,1515,6/29/22
13042,0,2,3,5,PHNTM08,1609,6/29/22
13043,1,2,1,4,RECON83,1518,6/29/22
13044,0,2,5,7,PHNTM,1530,6/29/22
13045,2,1,2,5,COACH21,1521,6/29/22
13046,2,1,7,10,COACH22,1524,6/29/22
13047,3,0,0,3,SMALL16,1530,6/29/22
13048,1,1,2,4,HANG51,1603,6/29/22
13049,2,1,4,7,HANG52,1606,6/29/22
13050,1,2,2,5,FILL21,1609,6/29/22
13051,1,2,1,4,FILL32,1612,6/29/22
13052,1,2,0,3,WIRE31,1612,6/29/22
13053,1,2,3,6,WIRE32,1636,6/29/22
13054,0,1,3,4,HOOK34,1615,6/29/22
13055,2,1,2,5,HOOK02,1624,6/29/22
13056,1,2,3,6,AXLE11,1627,6/29/22
13057,1,2,4,7,AXLE22,1630,6/29/22
13058,1,3,4,8,DRAGN33,1633,6/29/22
13059,1,1,6,8,RENO71,1639,6/29/22
13060,1,1,5,7,RENO72,1642,6/29/22
13061,1,5,1,7,CRAZE14,1645,6/29/22
13062,0,2,3,5,HOOK59,1618,6/29/22
13063,2,2,4,8,AMMO06,1827,6/29/22
13064,2,2,3,7,BADGR04,1833,6/29/22
13065,1,2,2,5,COACH21,1821,6/29/22
13066,1,2,1,4,COACH22,1824,6/29/22
13067,2,4,4,10,AMMO08,1830,6/29/22
13068,1,4,1,6,FURY02,1851,6/29/22
13069,4,0,5,9,SMALL06,906,6/30/22
13070,0,0,4,4,HOOK31,903,6/30/22
13071,0,0,0,0,DRAGN51,909,6/30/22
13072,2,0,7,9,DRAGN71,1057,6/30/22
13073,1,0,1,2,BALL85,1103,6/30/22
13074,1,0,4,5,HOOK59,900,6/30/22
13075,1,1,2,4,DRAGN05,921,6/30/22
13076,1,1,1,3,BALL88,915,6/30/22
13077,1,1,1,3,DRAGN02,921,6/30/22
13078,1,1,2,4,FURY01,930,6/30/22
13079,3,1,1,5,FURY05,933,6/30/22
13080,4,0,1,5,SMALL22,942,6/30/22
13081,1,0,3,4,AXEL11,945,6/30/22
13082,4,0,1,5,AXEL11,948,6/30/22
13083,1,0,5,6,CRAZE43,939,6/30/22
13084,1,1,3,5,EPIC02,1006,6/30/22
13085,2,1,3,6,DAWG08,1009,6/30/22
13086,2,0,1,3,TORA21,957,6/30/22
13087,2,0,3,5,TORA21,1000,6/30/22
13088,2,0,2,4,CRAZE13,1003,6/30/22
13089,3,0,2,5,SMALL35,1015,6/30/22
13090,3,0,0,3,SMALL36,1018,6/30/22
13091,2,1,1,4,DAWG02,1012,6/30/22
13092,1,1,2,4,CREEP31,1021,6/30/22
13093,1,1,3,5,CREEP32,1024,6/30/22
13094,3,0,0,3,SMALL25,951,6/30/22
13095,3,0,0,3,SMALL26,956,6/30/22
13096,2,2,2,6,FILL31,1133,6/30/22
13097,2,2,2,6,FILL32,1136,6/30/22
13098,1,1,3,5,MANLY21,1051,6/30/22
13099,1,1,3,5,MANLY22,1054,6/30/22
13100,2,1,0,3,SLOW11,1103,6/30/22
13101,1,1,1,3,SLOW12,1106,6/30/22
13102,1,2,0,3,EASY42,1140,6/30/22
13103,2,1,3,6,SLOW81,1145,6/30/22
13104,1,1,0,2,SLOW82,1148,6/30/22
13105,1,2,0,3,SHINR81,1151,6/30/22
13106,1,2,3,6,SHINR82,1154,6/30/22
13107,0,1,4,5,PAWS09,1157,6/30/22
13108,1,2,3,6,VEGA21,1230,6/30/22
13109,4,2,2,8,VEGA24,1233,6/30/22
13110,1,1,1,3,HANG51,1221,6/30/22
13111,1,0,6,7,HANG51,1224,6/30/22
13112,1,1,5,7,HOOK37,1057,6/30/22
13113,2,2,1,5,EVIL01,1227,6/30/22
13114,2,2,2,6,AXLE11,1242,6/30/22
13115,2,2,1,5,AXLE11,1245,6/30/22
13116,2,2,5,9,HOOK38,1245,6/30/22
13117,3,2,2,7,SMALL24,1248,6/30/22
13118,3,3,2,8,SMALL21,1239,6/30/22
13119,2,3,1,6,SLOW51,1139,6/30/22
13120,1,2,1,4,SLOW51,1142,6/30/22
13121,1,0,5,6,DRAGN76,1257,6/30/22
13122,1,2,4,7,HOOK81,1303,6/30/22
13123,0,2,3,5,DRAGN51,1300,6/30/22
13124,3,0,3,6,SCARE05,1309,6/30/22
13125,1,2,4,7,BUBO32,1254,6/30/22
13126,4,3,0,7,SMALL40,1324,6/30/22
13127,3,2,2,7,SCARE99,1312,6/30/22
13128,4,2,0,6,SMALL37,1321,6/30/22
13129,0,3,4,7,FURY01,1315,6/30/22
13130,1,5,1,7,CRAZE14,1327,6/30/22
13131,6,2,4,12,DRAGN31,1318,6/30/22
13132,1,2,3,6,CREEP31,1339,6/30/22
13133,1,2,1,4,CREEP31,1342,6/30/22
13134,0,2,3,5,AMMO01,1333,6/30/22
13135,1,2,1,4,EPIC09,1330,6/30/22
13136,3,2,0,5,SMALL43,1336,6/30/22
13137,1,2,1,4,RECON88,1345,6/30/22
13138,1,3,2,6,BALL85,1348,6/30/22
13139,4,2,1,7,SMALL76,1454,6/30/22
13140,1,1,0,2,DRAGN62,1451,6/30/22
13141,3,2,3,8,SMALL05,1503,6/30/22
13142,3,2,3,8,SMALL11,1515,6/30/22
13143,3,2,4,9,SMALL10,1512,6/30/22
13144,0,3,5,8,RECON82,1509,6/30/22
13145,2,1,2,5,DAWG02,1521,6/30/22
13146,2,3,6,11,DAWG08,1524,6/30/22
13147,1,2,4,7,AXLE11,1530,6/30/22
13148,4,2,0,6,AXLE12,1530,6/30/22
13149,4,2,2,8,PHNTM08,1518,6/30/22
13150,0,3,2,5,BALL41,1527,6/30/22
13151,1,2,6,9,SHNR81,1539,6/30/22
13152,1,2,7,10,SHNR82,1539,6/30/22
13153,3,2,2,7,BALL83,1548,6/30/22
13154,1,3,2,6,EASY42,1546,6/30/22
13155,1,3,3,7,TORA71,1600,6/30/22
13156,1,3,2,6,TORA72,1601,6/30/22
13157,0,3,0,3,PAWS47,1609,6/30/22
13158,3,2,2,7,DRAGN73,1612,6/30/22
13159,0,3,2,5,HOOK22,1633,6/30/22
13160,1,3,2,6,PAWS13,1554,6/30/22
13161,1,2,5,8,DRAGN55,1645,6/30/22
13162,1,2,1,4,POST21,1636,6/30/22
13163,1,2,3,6,POST22,1639,6/30/22
13164,2,2,3,7,CREEP31,1621,6/30/22
13165,4,2,1,7,CREEP32,1624,6/30/22
13166,0,2,2,4,DRAGN33,1645,6/30/22
13167,3,1,1,5,SMALL10,1812,6/30/22
13168,2,2,3,7,AMMO03,1818,6/30/22
13169,1,2,0,3,COACH21,1845,6/30/22
13170,1,2,1,4,COACH22,1848,6/30/22
13171,0,1,4,5,DRAGN38,1851,6/30/22
13172,0,2,6,8,PHATM08,1903,6/30/22
13173,0,2,5,7,BALL41,0,6/30/22
13174,1,2,5,8,Creep31,1030,7/5/22
13175,1,2,6,9,creep32,1033,7/5/22
13176,4,1,6,11,craze09,1042,7/5/22
13177,0,3,3,6,Ball11,1036,7/5/22
13178,1,2,8,11,AXLE11,1045,7/5/22
13179,1,2,5,8,AXLE12,1048,7/5/22
13180,1,1,8,10,VEGA21,1051,7/5/22
13181,1,1,5,7,VEGA22,1054,7/5/22
13182,0,0,0,0,WIRE31,1057,7/5/22
13183,1,1,6,8,WIRE31,1057,7/5/22
13184,1,1,3,5,WIRE32,1100,7/5/22
13185,1,1,4,6,RENO71,1103,7/5/22
13186,1,1,8,10,RENO72,1106,7/5/22
13187,0,1,8,9,BALL82,1109,7/5/22
13188,0,1,6,7,FURY08,1115,7/5/22
13189,0,1,5,6,RECON85,1112,7/5/22
13190,0,3,5,8,LOOT08,1121,7/5/22
13191,2,2,8,12,BALL88,1118,7/5/22
13192,2,1,0,3,PAWS88,1124,7/5/22
13193,2,3,9,14,EPIC06,1136,7/5/22
13194,0,1,2,3,FURY03,1127,7/5/22
13195,1,3,8,12,EPIC02,1133,7/5/22
13196,1,4,3,8,CRAZE14,1139,7/5/22
13197,1,2,4,7,BADGER05,1200,7/5/22
13198,1,1,3,5,BALL02,1203,7/5/22
13199,3,3,7,13,FURY05,1239,7/5/22
13200,4,2,4,10,SMALL78,1242,7/5/22
13201,0,3,5,8,HOOK36,1330,7/5/22
13202,2,2,3,7,VEGA21,1336,7/5/22
13203,2,2,1,5,VEGA22,1339,7/5/22
13204,1,2,4,7,AXLE11,1342,7/5/22
13205,1,2,2,5,AXLE12,1345,7/5/22
13206,1,1,3,5,MANLY99,1350,7/5/22
13207,1,2,5,8,HOOK55,1351,7/5/22
13208,0,2,3,5,DRAGN51,1357,7/5/22
13209,0,3,1,4,PAWS42,1403,7/5/22
13210,2,1,3,6,HOOK33,1354,7/5/22
13211,1,1,3,5,HOOK53,1348,7/5/22
13212,0,6,1,7,HOOK62,1415,7/5/22
13213,1,3,2,6,DRAGN59,1400,7/5/22
13214,2,2,3,7,SHINR81,1406,7/5/22
13215,1,2,4,7,SHINR82,1409,7/5/22
13216,1,3,1,5,RENO71,1427,7/5/22
13217,1,3,3,7,RENO72,1430,7/5/22
13218,1,5,4,10,HOOK81,1424,7/5/22
13219,2,3,0,5,CREEP31,1418,7/5/22
13220,1,3,2,6,CREEP32,1421,7/5/22
13221,2,3,1,6,CRAZE88,1412,7/5/22
13222,1,1,2,4,HANG51,1436,7/5/22
13223,1,1,2,4,HANG52,1439,7/5/22
13224,3,2,1,6,SMALL73,1445,7/5/22
13225,2,3,2,7,DRAGN71,1433,7/5/22
13226,1,3,2,6,LOST21,1451,7/5/22
13227,1,3,2,6,LOST22,1454,7/5/22
13228,1,4,2,7,TORA31,1457,7/5/22
13229,1,4,3,8,TORA32,1500,7/5/22
13230,0,5,4,9,DRAGN05,1503,7/5/22
13231,6,3,1,10,HOOK02,1442,7/5/22
13232,1,3,1,5,GOLEM61,1512,7/5/22
13233,1,3,2,6,GOLEM62,1515,7/5/22
13234,1,6,1,8,TORA71,1506,7/5/22
13235,1,6,1,8,TORA72,1509,7/5/22
13236,1,6,4,11,SCARE38,1730,7/5/22
13237,4,3,3,10,DRAGN62,1733,7/5/22
13238,2,3,5,10,VEGA21,1736,7/5/22
13239,2,3,3,8,VEGA22,1739,7/5/22
13240,0,3,3,6,DRAGN53,1748,7/5/22
13241,2,6,3,11,TAUNT21,1742,7/5/22
13242,2,6,5,13,TAUNT22,1745,7/5/22
13243,1,3,4,8,DRAGN55,1800,7/5/22
13244,0,2,1,3,DRAGN51,1754,7/5/22
13245,0,4,6,10,HOOK81,1757,7/5/22
13246,1,3,4,8,BUBO32,1803,7/5/22
13247,0,3,4,7,DRAGN05,1806,7/5/22
13248,2,5,2,9,DRAGN69,1818,7/5/22
13249,4,3,3,10,DRAGN33,1751,7/5/22
13250,3,3,1,7,SMALL10,1812,7/5/22
13251,1,3,3,7,RENO71,1824,7/5/22
13252,4,3,2,9,RENO72,1824,7/5/22
13253,1,5,3,9,HANG51,1830,7/5/22
13254,1,5,2,8,HANG52,1833,7/5/22
13255,2,2,3,7,DRAGN02,1821,7/5/22
13256,2,3,2,7,DRAGN73,1836,7/5/22
13257,2,3,7,12,PAWS 25,636,7/6/22
13258,1,0,8,9,AXLE 11,630,7/6/22
13259,1,0,10,11,AXLE 12,633,7/6/22
13260,1,0,5,6,COACH 21,642,7/6/22
13261,1,0,8,9,COACH 22,645,7/6/22
13262,1,1,8,10,TORA 21,648,7/6/22
13263,1,1,8,10,TORA 22,651,7/6/22
13264,0,5,3,8,AMMO 01,639,7/6/22
13265,0,1,8,9,RECON 81,654,7/6/22
13266,1,0,6,7,WIRE 31,657,7/6/22
13267,1,0,7,8,WIRE 32,700,7/6/22
13268,2,1,6,9,DAWG 02,712,7/6/22
13269,2,1,7,10,BALL 08,709,7/6/22
13270,0,0,9,9,LOOT 08,715,7/6/22
13271,2,1,7,10,BALL 99,703,7/6/22
13272,0,0,5,5,PAWS 46,706,7/6/22
13273,0,1,5,6,BALL 41,718,7/6/22
13274,0,1,8,9,LOOT 50,721,7/6/22
13275,3,1,5,9,FURY 08,730,7/6/22
13276,1,0,4,5,FURY 02,733,7/6/22
13277,1,2,5,8,EPIC 01,736,7/6/22
13278,0,0,6,6,RECON 85,724,7/6/22
13279,2,1,4,7,EPIC 06,742,7/6/22
13280,1,2,4,7,EPIC 09,745,7/6/22
13281,2,0,5,7,RENO 71,748,7/6/22
13282,1,0,1,2,RENO 72,751,7/6/22
13283,1,4,6,11,FURY 05,815,7/6/22
13284,2,1,4,7,GIZMO 31,821,7/6/22
13285,2,1,4,7,GIZMO 32,824,7/6/22
13286,1,1,6,8,EPIC 08,839,7/6/22
13287,1,4,7,12,BUBO 11,827,7/6/22
13288,1,4,4,9,BUBO 12,830,7/6/22
13289,0,3,2,5,LOST 21,832,7/6/22
13290,1,5,0,6,EASY 42,930,7/6/22
13291,1,3,2,6,CREEP 31,1036,7/6/22
13292,1,3,0,4,CREEP 32,1039,7/6/22
13293,1,3,7,11,AXLE 11,1042,7/6/22
13294,1,3,8,12,AXLE 12,1045,7/6/22
13295,1,2,11,14,VEGA 21,1030,7/6/22
13296,1,2,9,12,VEGA 22,1033,7/6/22
13297,2,0,7,9,BALL 25,1048,7/6/22
13298,1,5,8,14,TORA 21,1057,7/6/22
13299,1,5,7,13,TORA 22,1054,7/6/22
13300,1,1,4,6,WIRE 31,1057,7/6/22
13301,4,1,3,8,WIRE 32,1100,7/6/22
13302,1,3,8,12,STAB 11,1106,7/6/22
13303,1,3,8,12,STAB 12,1109,7/6/22
13304,2,4,5,11,DAWG 02,1112,7/6/22
13305,1,1,7,9,BALL 88,1121,7/6/22
13306,2,1,6,9,RECON 85,1115,7/6/22
13307,2,3,6,11,DAWG 01,1118,7/6/22
13308,1,4,8,13,COBRA 04,1130,7/6/22
13309,1,1,2,4,RECON 83,1124,7/6/22
13310,1,2,2,5,CRAZE 14,1136,7/6/22
13311,1,1,3,5,EPIC 01,1139,7/6/22
13312,2,2,5,9,EPIC 06,1142,7/6/22
13313,1,2,6,9,BALL 81,1133,7/6/22
13314,1,4,5,10,EPIC 09,1145,7/6/22
13315,1,4,8,13,COBRA04,1130,7/6/22
13316,1,2,5,8,FURY02,1127,7/6/22
13317,1,1,5,7,BALL82,1200,7/6/22
13318,1,4,8,13,FURY05,1203,7/6/22
13319,2,1,6,9,RECON04,1215,7/6/22
13320,1,6,4,11,EPIC08,1239,7/6/22
13321,3,3,1,7,DRAGN02,1339,7/6/22
13322,0,3,5,8,HOOK34,1336,7/6/22
13323,3,3,2,8,SMALL55,1333,7/6/22
13324,3,4,1,8,SMALL52,1354,7/6/22
13325,1,3,4,8,VEGA21,1342,7/6/22
13326,1,3,1,5,VEGA22,1345,7/6/22
13327,2,5,3,10,TAUNT21,1330,7/6/22
13328,2,5,1,8,TAUNT22,1348,7/6/22
13329,1,4,2,7,HOOK53,1351,7/6/22
13330,3,6,4,13,HOOK47,1403,7/6/22
13331,0,3,0,3,HOOK59,1400,7/6/22
13332,1,3,2,6,SCARE05,1406,7/6/22
13333,2,2,3,7,HOOK33,1357,7/6/22
13334,0,4,3,7,HOOK62,1421,7/6/22
13335,1,3,1,5,WIRE31,1409,7/6/22
13336,4,3,1,8,WIRE32,1412,7/6/22
13337,1,5,1,7,SLOW21,1415,7/6/22
13338,1,5,5,11,SLOW22,1418,7/6/22
13339,2,5,2,9,DRAGN66,1427,7/6/22
13340,1,5,2,8,RENO71,1430,7/6/22
13341,1,5,2,8,RENO72,1433,7/6/22
13342,0,2,3,5,COBRA04,1424,7/6/22
13343,1,5,4,10,HANG51,1436,7/6/22
13344,1,5,0,6,HANG52,1439,7/6/22
13345,1,6,2,9,TORA81,1457,7/6/22
13346,1,6,3,10,TORA82,1500,7/6/22
13347,2,4,3,9,SLOW11,1451,7/6/22
13348,1,4,3,8,SLOW12,1454,7/6/22
13349,3,5,1,9,SMALL72,1442,7/6/22
13350,1,3,3,7,ETCH41,1445,7/6/22
13351,1,3,1,5,ETCH42,1448,7/6/22
13352,0,2,6,8,DRAGN48,1503,7/6/22
13353,1,3,5,9,HOOK48,1903,7/6/22
13354,1,5,1,7,FILL31,1506,7/6/22
13355,1,5,1,7,FILL32,1509,7/6/22
13356,1,6,1,8,GOLEM61,1512,7/6/22
13357,1,6,1,8,GOLEM62,1515,7/6/22
13358,0,2,6,8,HOOK 94,1736,7/6/22
13359,0,6,1,7,HOOK 01,1733,7/6/22
13360,0,4,3,7,LOOT 14,1745,7/6/22
13361,0,6,2,8,HOOK 26,1739,7/6/22
13362,2,5,5,12,TAUNT 21,1742,7/6/22
13363,2,2,0,4,STAB 11,1751,7/6/22
13364,2,2,1,5,STAB 12,1754,7/6/22
13365,1,3,3,7,HOOK 81,1800,7/6/22
13366,2,4,0,6,DRAGN 33,1757,7/6/22
13367,0,4,5,9,DRAGN 05,1636,7/6/22
13368,0,6,3,9,HOOK62,1818,7/6/22
13369,2,3,4,9,DRAGN 61,1812,7/6/22
13370,3,6,2,11,SMALL 13,1821,7/6/22
13371,4,5,3,12,WIRE 31,1803,7/6/22
13372,1,5,4,10,WIRE 32,1806,7/6/22
13373,2,5,2,9,DRAGN 69,1821,7/6/22
13374,2,5,3,10,DRAGN 66,1818,7/6/22
13375,1,5,4,10,RENO 71,1833,7/6/22
13376,1,5,3,9,RENO 72,1836,7/6/22
13377,1,6,3,10,DRAGN 71,1830,7/6/22
13378,2,5,2,9,DRAGN 75,1827,7/6/22
13379,3,3,2,8,SMALL 21,1839,7/6/22
13380,1,6,4,11,HOOK91,1842,7/6/22
13381,1,1,7,9,RENO71,639,7/7/22
13382,2,2,6,10,EVIL03,651,7/7/22
13383,4,2,3,9,COACH21,818,7/7/22
13384,1,2,7,10,VEGA21,645,7/7/22
13385,2,2,6,10,RECON05,654,7/7/22
13386,1,0,6,7,AXLE11/12,700,7/7/22
13387,3,2,3,8,SMALL27,657,7/7/22
13388,2,1,7,10,WIRE31/32,706,7/7/22
13389,2,1,5,8,SHINR81,712,7/7/22
13390,2,1,3,6,SMALL41,727,7/7/22
13391,1,4,6,11,CRAZE09,736,7/7/22
13392,1,1,6,8,FURY05,730,7/7/22
13393,0,0,5,5,FURY08,733,7/7/22
13394,2,1,8,11,STAB11,903,7/7/22
13395,0,3,5,8,LOOT50,724,7/7/22
13396,1,4,5,10,EPIC08,739,7/7/22
13397,1,3,5,9,EPIC06,742,7/7/22
13398,2,1,2,5,RHINO99,630,7/7/22
13399,1,0,4,5,RECON82,751,7/7/22
13400,1,3,4,8,EPIC-1,748,7/7/22
13401,1,1,4,6,RECON04,754,7/7/22
13402,1,5,8,14,MANLY11,800,7/7/22
13403,2,2,3,7,SLOW21/22,824,7/7/22
13404,1,3,2,6,BALL38,830,7/7/22
13405,3,6,4,13,PAWS 81/82,818,7/7/22
13406,4,3,3,10,HAN65,839,7/7/22
13407,4,5,6,15,GIZMO31,833,7/7/22
13408,1,5,0,6,EASY42,1000,7/7/22
13409,1,3,5,9,WIRE31,1033,7/7/22
13410,2,1,8,11,AMMO07,1042,7/7/22
13411,1,1,2,4,AMMO01,1039,7/7/22
13412,1,4,8,13,CREEP 31,1045,7/7/22
13413,2,2,5,9,EVIL03,1054,7/7/22
13414,2,2,7,11,RECON05,1051,7/7/22
13415,2,3,7,12,BALL31,1057,7/7/22
13416,2,1,8,11,RENO71,1100,7/7/22
13417,0,1,4,5,FURY08,1130,7/7/22
13418,2,3,9,14,DAWG01,0,7/7/22
13419,1,2,7,10,BALL42,1112,7/7/22
13420,0,4,8,12,BALL08,1106,7/7/22
13421,0,2,7,9,PHANTOM08,1115,7/7/22
13422,4,2,5,11,EVIL01,1118,7/7/22
13423,2,1,8,11,HANG59,1127,7/7/22
13424,1,5,7,13,EPIC08,1136,7/7/22
13425,1,4,7,12,FURY05,1127,7/7/22
13426,1,5,6,12,EPIC01,1139,7/7/22
13427,1,4,4,9,EPIC06,1142,7/7/22
13428,1,2,2,5,CRAZE14                                                                                                                                                                                                                                      CRAZE14,1145,7/7/22
13429,0,5,3,8,CRAZE09,1133,7/7/22
13430,2,1,4,7,STAB11,1203,7/7/22
13431,0,2,2,4,CRAZE88,1239,7/7/22
13432,1,1,4,6,WIRE31,1333,7/7/22
13433,4,2,3,9,BALL04,1339,7/7/22
13434,4,2,2,8,HANG51,1342,7/7/22
13435,1,1,2,4,ETCH41,1348,7/7/22
13436,3,2,0,5,SMALL96,1406,7/7/22
13437,1,1,3,5,CREEP31,1354,7/7/22
13438,0,2,1,3,HOOK59,1351,7/7/22
13439,0,2,2,4,HOOK33,1400,7/7/22
13440,2,1,3,6,AXLE11,1412,7/7/22
13441,2,2,0,4,GOLEM61,1421,7/7/22
13442,0,2,2,4,HOOK67,1418,7/7/22
13443,4,2,1,7,SAMLL70,1436,7/7/22
13444,1,1,3,5,COACH21,1445,7/7/22
13445,5,4,2,11,DRAGN71,1442,7/7/22
13446,2,6,2,10,VEGA21,1457,7/7/22
13447,0,8,2,10,HOOK81,1506,7/7/22
13448,0,4,2,6,HOOK91,1451,7/7/22
13449,1,2,3,6,GIZMO21,1509,7/7/22
13450,2,6,3,11,TORA71,1515,7/7/22
13451,3,2,1,6,SMALL65,1727,7/7/22
13452,1,4,3,8,AXLE11,1721,7/7/22
13453,1,4,3,8,AXLE12,1724,7/7/22
13454,1,3,1,5,PHNTM55,1750,7/7/22
13455,0,4,7,11,HOOK53,1736,7/7/22
13456,0,2,3,5,DRAGN51,1733,7/7/22
13457,0,3,4,7,HOOK33,1739,7/7/22
13458,2,3,3,8,DRAGN62,1718,7/7/22
13459,1,8,2,11,POST61,1742,7/7/22
13460,1,8,4,13,POST62,1745,7/7/22
13461,0,3,4,7,DRAGN48,1748,7/7/22
13462,2,7,3,12,DRAGN61,1806,7/7/22
13463,0,6,4,10,HOOK37,1754,7/7/22
13464,3,4,2,9,SMALL04,1800,7/7/22
13465,1,6,2,9,HANG51,1809,7/7/22
13466,1,6,2,9,HANG52,1812,7/7/22
13467,4,3,2,9,DRAGN65,1757,7/7/22
13468,1,3,2,6,EVIL10,1818,7/7/22
13469,0,4,6,10,HOOK02,1751,7/7/22
13470,1,3,3,7,DRAGN71,1815,7/7/22
13471,1,2,4,7,WIRE31,630,7/8/22
13472,2,2,7,11,WIRE32,633,7/8/22
13473,2,2,5,9,EVIL03,648,7/8/22
13474,2,2,7,11,BALL25,642,7/8/22
13475,4,1,8,13,BADGR01,645,7/8/22
13476,2,2,5,9,BADGR05,706,7/8/22
13477,1,1,7,9,AXLE11,700,7/8/22
13478,1,1,6,8,AXLE12,700,7/8/22
13479,0,1,6,7,BALL31,657,7/8/22
13480,1,1,7,9,SCARE76,718,7/8/22
13481,1,1,6,8,CREEP31,706,7/8/22
13482,1,1,6,8,CREEP32,709,7/8/22
13483,2,0,8,10,STAB11,712,7/8/22
13484,1,0,7,8,STAB12,715,7/8/22
13485,3,1,3,7,SMALL41,727,7/8/22
13486,4,1,3,8,SMALL90,736,7/8/22
13487,1,2,7,10,EPIC06,733,7/8/22
13488,1,1,5,7,EPIC08,730,7/8/22
13489,1,2,4,7,BALL61,724,7/8/22
13490,0,2,6,8,EPIC02,739,7/8/22
13491,2,2,5,9,RENO71,742,7/8/22
13492,1,2,2,5,RENO72,742,7/8/22
13493,0,1,4,5,RECON83,748,7/8/22
13494,3,2,1,6,SMALL98,818,7/8/22
13495,2,1,3,6,GIZMO31,821,7/8/22
13496,2,1,3,6,GIZMO32,824,7/8/22
13497,0,1,5,6,CRAZE51,839,7/8/22
13498,3,2,5,10,BALL51,833,7/8/22
13499,1,1,2,4,EASY89,930,7/8/22
13500,1,3,2,6,COACH21,1030,7/8/22
13501,1,3,0,4,COACH22,1033,7/8/22
13502,2,2,7,11,EVIL02,1048,7/8/22
13503,1,3,8,12,AXLE11,1036,7/8/22
13504,1,3,8,12,AXLE12,1039,7/8/22
13505,0,3,2,5,DRAGN42,1124,7/8/22
13506,3,4,7,14,CREEP31,1042,7/8/22
13507,1,3,1,5,CREEP32,1045,7/8/22
13508,5,2,8,15,BADGR05,1051,7/8/22
13509,1,2,6,9,WIRE31,1057,7/8/22
13510,1,2,6,9,WIRE32,1100,7/8/22
13511,0,2,6,8,LOOT06,1109,7/8/22
13512,1,2,8,11,STAB11,1103,7/8/22
13513,1,2,6,9,STAB12,1106,7/8/22
13514,5,2,8,15,BADGR05,1051,7/8/22
13515,3,2,0,5,SMALL52,1054,7/8/22
13516,2,2,4,8,SMALL61,1115,7/8/22
13517,2,2,8,12,COBRA01,1112,7/8/22
13518,3,2,4,9,SMALL65,1127,7/8/22
13519,3,2,2,7,SMALL66,1130,7/8/22
13520,1,2,5,8,EPIC06,1136,7/8/22
13521,1,2,3,6,SCARE63,1145,7/8/22
13522,1,6,7,14,EPIC08,1133,7/8/22
13523,1,2,2,5,CRAZE14,1139,7/8/22
13524,2,3,1,6,SLOW61,1200,7/8/22
13525,2,3,1,6,SLOW62,1203,7/8/22
13526,0,2,5,7,RECON83,1142,7/8/22
13527,2,2,1,5,POST61,1154,7/8/22
13528,1,2,1,4,POST62,1157,7/8/22
13529,0,3,2,5,DRAGN34,1330,7/8/22
13530,1,5,1,7,WIRE31,1333,7/8/22
13531,1,5,3,9,WIRE32,1336,7/8/22
13532,0,3,0,3,PHNTM14,1342,7/8/22
13533,3,3,0,6,SMALL50,1348,7/8/22
13534,2,4,2,8,DRAGN52,1357,7/8/22
13535,3,4,1,8,SMALL55,1403,7/8/22
13536,0,3,4,7,HOOK75,1400,7/8/22
13537,2,2,1,5,DRAGN51,1406,7/8/22
13538,4,4,3,11,SMALL88,1424,7/8/22
13539,2,4,6,12,EPIC02,1415,7/8/22
13540,2,3,0,5,HOOK59,1354,7/8/22
13541,2,4,0,6,LOST21,1451,7/8/22
13542,2,4,0,6,LOST22,1453,7/8/22
13543,1,5,0,6,DRAWN21,1418,7/8/22
13544,2,5,1,8,DRAWN22,1421,7/8/22
13545,1,4,3,8,STAB11,1409,7/8/22
13546,4,4,0,8,STAB12,1412,7/8/22
13547,3,3,2,8,DRAGN67,1427,7/8/22
13548,2,3,0,5,DRAGN61,1430,7/8/22
13549,2,5,3,10,RENO71,1442,7/8/22
13550,2,5,3,10,RENO72,1445,7/8/22
13551,2,3,3,8,HOOK53,1351,7/8/22
13552,2,4,2,8,SLOW31,1457,7/8/22
13553,2,4,1,7,SLOW32,1500,7/8/22
13554,0,4,0,4,BALL62,1448,7/8/22
13555,2,4,3,9,TORA21,1442,7/8/22
13556,2,4,3,9,TORA22,1509,7/8/22
13557,3,3,2,8,TAUNT21,1521,7/8/22
13558,1,3,0,4,TAUNT22,1524,7/8/22
13559,2,4,1,7,LOOT55,1445,7/8/22
13560,0,4,1,5,SCARE17,1533,7/8/22
13561,1,5,2,8,FILL31,1339,7/8/22
13562,1,1,0,2,FILL32,1433,7/8/22
13563,4,3,0,7,CRAZE42,1539,7/8/22
13564,2,5,4,11,WIRE31,1730,7/8/22
13565,2,5,4,11,WIRE32,1730,7/8/22
13566,1,4,2,7,AXLE11,1736,7/8/22
13567,1,4,2,7,AXLE12,1742,7/8/22
13568,0,2,2,4,DRAGN62,1748,7/8/22
13569,2,4,3,9,DRAGN61,1615,7/8/22
13570,2,5,1,8,DRAGN67,1806,7/8/22
13571,2,3,0,5,PAWS88,1800,7/8/22
13572,1,6,2,9,HANG51,1821,7/8/22
13573,1,6,1,8,HANG52,1824,7/8/22
13574,0,2,5,7,HOOK38,1506,7/8/22
13575,3,2,3,8,DRAGN66,1812,7/8/22
13576,0,4,5,9,HOOK03,1827,7/8/22
13577,4,4,3,11,OUZO11,1800,7/8/22
13578,4,4,3,11,OUZO12,1803,7/8/22
13579,0,3,4,7,DRAGN71,1830,7/8/22
13580,2,4,0,6,GOLEM22,900,7/8/22
13581,2,4,2,8,MANLY22,900,7/8/22
13582,2,4,0,6,GOLEM21,900,7/8/22
13583,1,1,7,9,WIRE31,633,7/11/22
13584,1,1,5,7,WIRE32,633,7/11/22
13585,1,0,5,6,POST61,639,7/11/22
13586,1,0,4,5,POST62,639,7/11/22
13587,3,1,3,7,SMALL23,645,7/11/22
13588,2,1,3,6,SMALL27,657,7/11/22
13589,2,1,4,7,SMALL30,700,7/11/22
13590,1,1,5,7,RECON04,703,7/11/22
13591,1,1,4,6,EPIC01,706,7/11/22
13592,1,1,7,9,EPIC06,712,7/11/22
13593,0,1,7,8,EPIC02,709,7/11/22
13594,1,0,6,7,STAB11,651,7/11/22
13595,1,0,7,8,STAB12,651,7/11/22
13596,3,1,6,10,PHNTM48,715,7/11/22
13597,0,0,5,5,EPIC08,718,7/11/22
13598,1,0,5,6,POST61,727,7/11/22
13599,1,0,4,5,POST62,727,7/11/22
13600,0,1,7,8,CRAZE15,739,7/11/22
13601,1,0,5,6,RECON99,733,7/11/22
13602,0,0,5,5,RECON83,730,7/11/22
13603,2,0,4,6,BALL79,751,7/11/22
13604,1,0,7,8,CREEP31,742,7/11/22
13605,1,0,5,6,CREEP32,745,7/11/22
13606,2,1,5,8,AMMO03,748,7/11/22
13607,2,0,5,7,RECON71,754,7/11/22
13608,2,1,4,7,BADGR04,800,7/11/22
13609,2,0,2,4,BADGR,757,7/11/22
13610,1,2,3,6,VEGA21,803,7/11/22
13611,1,2,2,5,VEGA22,806,7/11/22
13612,1,1,5,7,TORA21,809,7/11/22
13613,1,1,3,5,TORA22,812,7/11/22
13614,1,1,7,9,BALL16,842,7/11/22
13615,0,1,4,5,BALL17,845,7/11/22
13616,2,0,2,4,HANG51,830,7/11/22
13617,1,0,1,2,HANG52,833,7/11/22
13618,1,1,1,3,FILL11,848,7/11/22
13619,1,1,3,5,FILL12,851,7/11/22
13620,1,1,2,4,EASY89,900,7/11/22
13621,4,0,4,8,WIRE31,1033,7/11/22
13622,1,0,6,7,WIRE32,1036,7/11/22
13623,2,1,9,12,HANG53,1039,7/11/22
13624,1,1,6,8,HANG54,1042,7/11/22
13625,0,2,0,2,PAWS88,1133,7/11/22
13626,1,1,8,10,SHINR81,1045,7/11/22
13627,1,1,8,10,SHINR82,1048,7/11/22
13628,0,1,2,3,BALL79,1051,7/11/22
13629,2,1,9,12,EPIC06,1103,7/11/22
13630,2,0,1,3,RHINO99,1030,7/11/22
13631,0,1,3,4,BALL51,1057,7/11/22
13632,1,1,8,10,EPIC02,1100,7/11/22
13633,1,1,7,9,PHNTM48,1106,7/11/22
13634,1,1,2,4,VEGA21,1054,7/11/22
13635,4,1,5,10,VEGA22,1115,7/11/22
13636,1,1,4,6,CRAZE14,1112,7/11/22
13637,1,2,8,11,EPIC08,1109,7/11/22
13638,4,1,4,9,SMALL63,1121,7/11/22
13639,2,1,8,11,PAWS15,1124,7/11/22
13640,0,1,4,5,RECON83,1127,7/11/22
13641,1,1,5,7,RECON04,1139,7/11/22
13642,1,1,4,6,COACH21,1145,7/11/22
13643,1,2,7,10,AXLE11,1151,7/11/22
13644,0,1,1,2,DRAGN33,1142,7/11/22
13645,4,3,3,10,SLOW55,1157,7/11/22
13646,2,1,3,6,POST61,1233,7/11/22
13647,0,1,4,5,DRAGN48,1239,7/11/22
13648,1,2,3,6,EASY89,1330,7/11/22
13649,0,1,3,4,DRAGN33,1333,7/11/22
13650,0,1,1,2,CRAZE42,1345,7/11/22
13651,0,2,3,5,DRAGN53,1336,7/11/22
13652,0,2,2,4,HOOK55,1339,7/11/22
13653,0,1,2,3,HOOK81,1342,7/11/22
13654,2,1,3,6,PAWS88,1351,7/11/22
13655,1,1,0,2,DRAGN96,1348,7/11/22
13656,0,3,2,5,HOOK62,1357,7/11/22
13657,2,2,3,7,DRAGN66,1354,7/11/22
13658,2,2,1,5,DRAGN69,1400,7/11/22
13659,3,2,0,5,SMALL57,1409,7/11/22
13660,4,2,3,9,DRAGN18,1412,7/11/22
13661,1,1,5,7,HANG51,1403,7/11/22
13662,1,2,4,7,SCARE11,1421,7/11/22
13663,1,1,4,6,WIRE31,1415,7/11/22
13664,1,3,2,6,AXLE11,1424,7/11/22
13665,0,2,3,5,HOOK02,1448,7/11/22
13666,1,2,2,5,HOOK22,1451,7/11/22
13667,1,3,4,8,SHINR81,1506,7/11/22
13668,1,1,4,6,GIZMO11,1518,7/11/22
13669,2,1,1,4,TORA71,1527,7/11/22
13670,2,2,0,4,PHNTM55,1454,7/11/22
13671,1,2,0,3,STAB11,1733,7/11/22
13672,1,2,4,7,STAB12,1736,7/11/22
13673,0,2,3,5,DRAGN55,1739,7/11/22
13674,0,3,2,5,HOOK81,1742,7/11/22
13675,1,2,4,7,GOLEM21,1757,7/11/22
13676,1,2,1,4,GOLEM22,22,7/11/22
13677,0,3,4,7,HOOK52,1745,7/11/22
13678,0,1,4,5,DRAGN41,1748,7/11/22
13679,4,2,3,9,SMALL75,1751,7/11/22
13680,3,2,1,6,SMALL11,1815,7/11/22
13681,2,2,3,7,DRAGN66,1803,7/11/22
13682,0,3,4,7,PHNTM55,1754,7/11/22
13683,1,2,0,3,RENO71,1806,7/11/22
13684,1,2,4,7,RENO72,1809,7/11/22
13685,0,3,5,8,HOOK19,1818,7/11/22
13686,2,2,3,7,DRAGN76,1812,7/11/22
13687,1,2,2,5,WIRE31,1821,7/11/22
13688,1,2,7,10,WIRE32,1821,7/11/22
13689,1,2,3,6,AXLE11,1830,7/11/22
13690,1,2,1,4,AXLE12,1833,7/11/22
13691,0,2,4,6,DRAGN21,1836,7/11/22
13692,1,2,3,6,DRAGN13,1839,7/11/22
13693,0,0,0,0,COBRA01,0,7/12/22
13694,0,2,6,8,COBRA01,633,7/12/22
13695,1,2,8,11,RENO71,636,7/12/22
13696,1,2,6,9,RENO72,639,7/12/22
13697,0,6,7,13,PAWS48,642,7/12/22
13698,1,1,6,8,SHINER81,651,7/12/22
13699,2,1,7,10,SHINER82,657,7/12/22
13700,1,2,5,8,BALL99,654,7/12/22
13701,2,5,3,10,BALL56,706,7/12/22
13702,1,2,7,10,STAB11,727,7/12/22
13703,2,2,6,10,STAB12,730,7/12/22
13704,1,1,8,10,GHOST02,732,7/12/22
13705,0,5,2,7,EPIC01,703,7/12/22
13706,0,4,7,11,RECON83,733,7/12/22
13707,0,6,9,15,FURY01,739,7/12/22
13708,2,2,7,11,POST61,745,7/12/22
13709,1,2,2,5,POST62,745,7/12/22
13710,0,3,7,10,BALL58,742,7/12/22
13711,1,3,1,5,RECON86,751,7/12/22
13712,0,4,2,6,CRAZE09,754,7/12/22
13713,1,3,2,6,COACH21,812,7/12/22
13714,4,3,1,8,COACH22,815,7/12/22
13715,0,4,2,6,AMMO01,806,7/12/22
13716,2,4,2,8,FURY02,824,7/12/22
13717,0,2,1,3,AMMO07,818,7/12/22
13718,1,4,1,6,VEGA21,827,7/12/22
13719,4,4,3,11,VEGA22,830,7/12/22
13720,2,4,6,12,BALL25,821,7/12/22
13721,1,4,3,8,FILL11,848,7/12/22
13722,1,4,4,9,FILL12,851,7/12/22
13723,2,5,3,10,GIZMO31,842,7/12/22
13724,2,5,3,10,GIZMO32,845,7/12/22
13725,1,4,6,11,BALL08,1030,7/12/22
13726,1,3,8,12,RENO71,1036,7/12/22
13727,1,3,5,9,RENO72,1036,7/12/22
13728,1,4,5,10,HOOK38,1051,7/12/22
13729,1,4,8,13,CREEP31,1045,7/12/22
13730,1,4,8,13,CREEP32,1045,7/12/22
13731,1,3,2,6,CRAZE14,1100,7/12/22
13732,1,4,5,10,EPIC06,1057,7/12/22
13733,1,4,6,11,EASY31,1035,7/12/22
13734,1,3,6,10,RECON04,1139,7/12/22
13735,0,3,5,8,FURY08,1133,7/12/22
13736,1,3,9,13,GHOST02,1136,7/12/22
13737,0,3,6,9,EPIC08,1103,7/12/22
13738,0,2,4,6,FURY05,1130,7/12/22
13739,0,4,4,8,FURY02,1127,7/12/22
13740,1,3,4,8,BALL79,1212,7/12/22
13741,2,2,3,7,AMMO01,1215,7/12/22
13742,2,2,4,8,AMMO07,1209,7/12/22
13743,1,4,4,9,BALL13,1206,7/12/22
13744,2,3,0,5,DRAGN42,1224,7/12/22
13745,2,4,2,8,RECON72,1227,7/12/22
13746,2,4,6,12,BADGR04,1230,7/12/22
13747,2,3,5,10,VEGA21,1233,7/12/22
13748,1,3,1,5,VEGA22,1233,7/12/22
13749,2,4,3,9,BUBO32,1239,7/12/22
13750,2,2,2,6,DRAGN11,1330,7/12/22
13751,2,5,4,11,DRAGN53,1333,7/12/22
13752,0,3,3,6,DRAGN44,1345,7/12/22
13753,1,5,2,8,DRAGN51,1339,7/12/22
13754,2,3,0,5,DRAGN67,1348,7/12/22
13755,1,5,1,7,SCARE01,1403,7/12/22
13756,0,4,1,5,DRAGN76,1357,7/12/22
13757,2,3,0,5,DRAGN72,1406,7/12/22
13758,4,4,2,10,DRAGN69,1351,7/12/22
13759,2,4,3,9,AXLE11,1412,7/12/22
13760,3,4,3,10,AXLE12,1412,7/12/22
13761,0,4,2,6,HOOK13,1418,7/12/22
13762,3,5,4,12,HOOK02,1354,7/12/22
13763,4,3,3,10,DRAGN18,1424,7/12/22
13764,2,4,2,8,DRAGN22,1421,7/12/22
13765,4,5,5,14,DRAGN19,1433,7/12/22
13766,0,0,0,0,DRGN,0,7/12/22
13767,3,4,5,12,DRGN31,1409,7/12/22
13768,0,5,3,8,HOOK81,1439,7/12/22
13769,2,5,2,9,DRAGN66,1427,7/12/22
13770,1,5,0,6,TAUNT21,1442,7/12/22
13771,1,5,1,7,TAUNT22,1445,7/12/22
13772,1,5,3,9,WIRE31,1448,7/12/22
13773,1,5,2,8,WIRE32,1448,7/12/22
13774,3,5,1,9,TORA11,1454,7/12/22
13775,3,5,3,11,TORA12,1457,7/12/22
13776,2,4,0,6,TORA21,1500,7/12/22
13777,1,4,2,7,TORA22,1503,7/12/22
13778,0,4,5,9,BALL17,1506,7/12/22
13779,2,5,3,10,Taunt71,1830,7/12/22
13780,2,5,1,8,Taunt72,1830,7/12/22
13781,1,3,4,8,Dragon51,1733,7/12/22
13782,1,5,4,10,Hook53,1730,7/12/22
13783,0,4,7,11,Hook52,1736,7/12/22
13784,0,5,2,7,Dragon67,1754,7/12/22
13785,1,4,3,8,Shinr81,1745,7/12/22
13786,1,4,3,8,Shinr82,1745,7/12/22
13787,1,2,1,4,DRAGON05,1751,7/12/22
13788,1,4,1,6,COACH21,1757,7/12/22
13789,1,4,3,8,COACH22,1757,7/12/22
13790,1,4,3,8,HANG51,1803,7/12/22
13791,1,4,4,9,HANG52,1803,7/12/22
13792,2,5,4,11,HOOK19,1815,7/12/22
13793,3,5,3,11,DRAGON11,1809,7/12/22
13794,0,5,3,8,HOOK94,1815,7/12/22
13795,1,4,4,9,AXEL11,1818,7/12/22
13796,1,4,3,8,AXEL12,1818,7/12/22
13797,2,4,3,9,DRAGN22,1833,7/12/22
13798,2,4,6,12,VEGA21,1827,7/12/22
13799,1,4,0,5,VEGA22,1827,7/12/22
13800,0,3,3,6,DRAGN21,1836,7/12/22
13801,2,1,6,9,COBRA01,630,7/13/22
13802,1,0,4,5,POST61,633,7/13/22
13803,4,0,2,6,POST62,636,7/13/22
13804,1,0,8,9,RENO71,639,7/13/22
13805,1,0,9,10,RENO72,642,7/13/22
13806,1,0,8,9,WIRE31,648,7/13/22
13807,0,0,9,9,WIRE32,651,7/13/22
13808,0,0,9,9,WIRE32,651,7/13/22
13809,3,0,3,6,SMALL36,718,7/13/22
13810,0,1,5,6,RECON69,706,7/13/22
13811,0,2,7,9,PHNTM48,715,7/13/22
13812,0,1,5,6,RECON83,739,7/13/22
13813,0,1,4,5,EPIC01,709,7/13/22
13814,1,1,6,8,FURY03,736,7/13/22
13815,1,0,4,5,FURY08,742,7/13/22
13816,2,0,6,8,AXLE11,748,7/13/22
13817,1,0,8,9,AXLE12,757,7/13/22
13818,1,1,7,9,BALL08,745,7/13/22
13819,1,1,6,8,ETCH41,800,7/13/22
13820,1,0,5,6,ETCH42,803,7/13/22
13821,2,1,4,7,AMMO07,809,7/13/22
13822,2,1,5,8,RECON05,812,7/13/22
13823,1,0,1,2,BALL21,824,7/13/22
13824,1,0,1,2,BALL22,827,7/13/22
13825,1,5,4,10,TORA21,839,7/13/22
13826,1,5,3,9,TORA22,842,7/13/22
13827,1,0,5,6,SCARE72,815,7/13/22
13828,1,1,4,6,GIZMO31,833,7/13/22
13829,1,1,4,6,GIZMO32,836,7/13/22
13830,0,2,3,5,BALL88,851,7/13/22
13831,0,2,0,2,CRAZE42,930,7/13/22
13832,1,2,7,10,CRAZE46,1030,7/13/22
13833,1,0,3,4,WIRE31,1039,7/13/22
13834,1,1,3,5,HANG51,1033,7/13/22
13835,4,0,2,6,HANG52,1036,7/13/22
13836,1,0,6,7,WIRE32,1045,7/13/22
13837,1,0,3,4,CREEP31,1048,7/13/22
13838,3,0,4,7,CREEP32,1051,7/13/22
13839,3,1,2,6,SMALL55,1103,7/13/22
13840,1,2,8,11,BALL42,1054,7/13/22
13841,2,1,6,9,STAB11,1057,7/13/22
13842,2,1,8,11,STAB12,1100,7/13/22
13843,1,2,7,10,PHNTM48,1106,7/13/22
13844,1,2,3,6,CRAZE14,1109,7/13/22
13845,1,2,5,8,DAWG01,1048,7/13/22
13846,2,0,3,5,DRAGN18,1139,7/13/22
13847,0,2,5,7,FURY08,1136,7/13/22
13848,0,2,6,8,recon83,1103,7/13/22
13849,0,1,7,8,FURY03,1130,7/13/22
13850,4,1,3,8,CLEMENTS,1206,7/13/22
13851,4,1,3,8,CRAZE16,1218,7/13/22
13852,2,1,2,5,EVIL03,1221,7/13/22
13853,2,1,5,8,RECON71,1215,7/13/22
13854,4,1,7,12,RECON05,1212,7/13/22
13855,1,1,6,8,POST61,1224,7/13/22
13856,1,1,6,8,POST62,1224,7/13/22
13857,1,3,0,4,DRAGON91,1230,7/13/22
13858,0,0,0,0,HANG51,0,7/13/22
13859,1,1,3,5,HANG51,1336,7/13/22
13860,1,1,2,4,HANG52,1336,7/13/22
13861,3,1,2,6,SMALL50,1348,7/13/22
13862,0,2,2,4,HOOK52,1333,7/13/22
13863,2,1,4,7,DRAGON62,1400,7/13/22
13864,1,1,4,6,DRAGON81,1342,7/13/22
13865,2,1,0,3,DRAGON67,1357,7/13/22
13866,2,1,0,3,CRAZE88,1351,7/13/22
13867,3,2,0,5,SMALL60,1412,7/13/22
13868,4,2,0,6,SMALL57,1409,7/13/22
13869,1,1,1,3,RENO71,1415,7/13/22
13870,4,1,0,5,RENO72,1415,7/13/22
13871,2,1,0,3,EVIL10,1430,7/13/22
13872,2,1,2,5,SHINR81,1424,7/13/22
13873,2,1,3,6,SHINR82,1424,7/13/22
13874,1,1,1,3,VEGA21,1433,7/13/22
13875,4,1,0,5,VEGA22,1433,7/13/22
13876,3,2,6,11,HOOK99,1448,7/13/22
13877,1,2,4,7,TAUNT21,1451,7/13/22
13878,1,2,0,3,TAUNT22,1451,7/13/22
13879,1,2,1,4,TORA32,1500,7/13/22
13880,3,2,1,6,GIZMO31,1503,7/13/22
13881,2,2,3,7,GIZMO32,1503,7/13/22
13882,1,2,0,3,MANLY11,1442,7/13/22
13883,3,3,1,7,GIZMO21,1509,7/13/22
13884,2,3,2,7,GIZMO22,1509,7/13/22
13885,0,1,1,2,DRAGN51,1730,7/13/22
13886,1,5,4,10,HOOK81,1736,7/13/22
13887,1,1,5,7,CREEP31,1739,7/13/22
13888,1,1,3,5,CREEP32,1739,7/13/22
13889,1,2,3,6,WIRE31,1745,7/13/22
13890,3,2,0,5,WIRE32,1824,7/13/22
13891,1,1,3,5,SHINR81,1748,7/13/22
13892,1,1,3,5,SHINR82,1751,7/13/22
13893,0,1,4,5,DRAGN44,1757,7/13/22
13894,4,1,1,6,DRAGN67,1806,7/13/22
13895,2,1,4,7,BUBO32,1754,7/13/22
13896,1,1,0,2,HANG51,1812,7/13/22
13897,2,1,2,5,HANG52,1815,7/13/22
13898,3,1,2,6,DRAGN91,1806,7/13/22
13899,2,2,4,8,HOOK76,1818,7/13/22
13900,2,2,1,5,DRAGN02,1809,7/13/22
13901,2,1,2,5,DRAGN11,1826,7/13/22
13902,2,2,2,6,TORA31,1857,7/13/22
13903,2,2,4,8,TORA32,1900,7/13/22
13904,3,1,4,8,LOOT14,1832,7/13/22
13905,1,3,1,5,COACH22,1830,7/13/22
13906,1,3,2,6,COACH21,1836,7/13/22
13907,4,3,0,7,CRAZE11,1839,7/13/22
13908,1,0,7,8,COACH21,630,7/14/22
13909,1,0,5,6,COACH22,633,7/14/22
13910,0,0,6,6,BALL43,824,7/14/22
13911,3,0,3,6,SMALL22,6420,7/14/22
13912,3,0,3,6,SMALL20,636,7/14/22
13913,1,0,7,8,SHINR81,648,7/14/22
13914,1,0,6,7,SHINR82,651,7/14/22
13915,1,0,10,11,WIRE31,654,7/14/22
13916,1,0,9,10,WIRE32,657,7/14/22
13917,1,1,5,7,EPIC02,706,7/14/22
13918,3,0,8,11,BALL56,709,7/14/22
13919,0,0,6,6,BALL01,700,7/14/22
13920,0,1,4,5,EPIC01,712,7/14/22
13921,2,1,6,9,AMMO01,718,7/14/22
13922,0,0,5,5,RECON83,715,7/14/22
13923,0,1,3,4,BALL63,715,7/14/22
13924,1,0,8,9,GHOST02,733,7/14/22
13925,1,0,5,6,AMMO06,745,7/14/22
13926,0,1,6,7,LOOT48,742,7/14/22
13927,0,0,1,1,FURY02,730,7/14/22
13928,2,0,5,7,RECON71,751,7/14/22
13929,2,0,6,8,BADGR04,757,7/14/22
13930,1,0,5,6,CREEP31,803,7/14/22
13931,1,0,2,3,CREEP32,806,7/14/22
13932,2,1,4,7,RECON05,748,7/14/22
13933,2,1,4,7,LOOT06,751,7/14/22
13934,1,0,3,4,BALL21,800,7/14/22
13935,2,0,2,4,HANG51,822,7/14/22
13936,1,0,3,4,HANG52,830,7/14/22
13937,1,1,6,8,GOLEM21,809,7/14/22
13938,1,1,4,6,GOLEM22,812,7/14/22
13939,2,2,4,8,SLOW51,842,7/14/22
13940,2,2,2,6,SLOW52,845,7/14/22
13941,1,2,6,9,GIZMO31,836,7/14/22
13942,1,2,6,9,GIZMO32,839,7/14/22
13943,3,1,3,7,SMALL45,1039,7/14/22
13944,1,1,7,9,AXLE11,1035,7/14/22
13945,1,1,7,9,AXLE12,1038,7/14/22
13946,1,1,8,10,CREEP31,1045,7/14/22
13947,1,1,8,10,CREEP32,1048,7/14/22
13948,1,1,10,12,STAB11,1051,7/14/22
13949,1,1,11,13,STAB22,1054,7/14/22
13950,1,2,3,6,CRAZE14,1103,7/14/22
13951,0,0,8,8,RHINO99,1030,7/14/22
13952,2,1,5,8,AMMO01,1106,7/14/22
13953,1,1,8,10,EPIC06,1100,7/14/22
13954,1,1,6,8,PHNTM48,1109,7/14/22
13955,2,1,4,7,AMMO06,1145,7/14/22
13956,1,1,5,7,EPIC01,1057,7/14/22
13957,2,1,6,9,FURY08,1118,7/14/22
13958,0,1,4,5,BALL62,1112,7/14/22
13959,2,2,8,12,FURY01,1115,7/14/22
13960,1,1,4,6,FURY06,1121,7/14/22
13961,1,2,5,8,BADGR05,1124,7/14/22
13962,3,2,2,7,DRAGN01,1136,7/14/22
13963,1,2,1,4,DRAGN19,1130,7/14/22
13964,2,1,4,7,AMMO06,1145,7/14/22
13965,2,1,3,6,BUBO32,1151,7/14/22
13966,3,2,3,8,BADGR04,1157,7/14/22
13967,3,1,4,8,SMALL76,1154,7/14/22
13968,4,1,4,9,CRAZE16,1200,7/14/22
13969,2,1,5,8,RECON05,1148,7/14/22
13970,0,1,2,3,CRAZE88,1142,7/14/22
13971,2,1,5,8,POST61,1224,7/14/22
13972,1,1,6,8,POST62,1224,7/14/22
13973,1,2,1,4,MANLY11,1230,7/14/22
13974,1,2,3,6,MANLY12,1230,7/14/22
13975,0,1,1,2,DRAGN62,1342,7/14/22
13976,0,2,4,6,HOOK53,1333,7/14/22
13977,0,3,2,5,PAWS42,1339,7/14/22
13978,0,1,3,4,DRAGN33,1336,7/14/22
13979,3,2,0,5,SMALL50,1348,7/14/22
13980,2,2,4,8,LOOT06,1351,7/14/22
13981,0,2,3,5,DRAGN42,1354,7/14/22
13982,0,2,1,3,HOOK59,1345,7/14/22
13983,2,1,0,3,DRAGN67,1400,7/14/22
13984,0,1,6,7,DRAGN48,1357,7/14/22
13985,0,3,2,5,HOOK61,0,7/14/22
13986,2,1,0,3,DRAGN72,1403,7/14/22
13987,4,1,0,5,SMALL60,1412,7/14/22
13988,1,2,2,5,DRAGN71,1409,7/14/22
13989,1,1,3,5,CREEP31,1415,7/14/22
13990,4,1,3,8,CREEP32,1418,7/14/22
13991,1,1,3,5,WIRE31,1421,7/14/22
13992,1,1,2,4,WIRE32,1424,7/14/22
13993,2,3,0,5,EVIL10,1430,7/14/22
13994,2,2,5,9,DRAGN22,1427,7/14/22
13995,1,2,0,3,EASY81,1435,7/14/22
13996,3,2,1,6,DRAGN73,1433,7/14/22
13997,1,3,1,5,LOST31,1457,7/14/22
13998,1,3,1,5,LOST32,1500,7/14/22
13999,1,2,1,4,OUZO11,1515,7/14/22
14000,1,2,1,4,OUZO12,1518,7/14/22
14001,1,3,0,4,FILL41,1503,7/14/22
14002,1,3,3,7,FILL42,1506,7/14/22